ibge;municipio;Masculino;Feminino;Total;perc_masc;perc_feminino
421310;PIRATUBA;1575;2062;3637;0,433049216;0,566950784
260960;OLINDA;180068;213666;393734;0,457334139;0,542665861
354850;SANTOS;198613;235378;433991;0,457643131;0,542356869
261160;RECIFE;760645;900372;1661017;0,457939323;0,542060677
354880;SAO CAETANO DO SUL;74748;88015;162763;0,459244423;0,540755577
292740;SALVADOR;1332518;1567801;2900319;0,459438427;0,540561573
221130;VALENCA DO PIAUI;9641;11299;20940;0,460410697;0,539589303
221100;TERESINA;401387;469739;871126;0,460768017;0,539231983
270430;MACEIO;475359;556238;1031597;0,46079913;0,53920087
280030;ARACAJU;310261;362353;672614;0,461276453;0,538723547
353286;NOVA CASTILHO;597;693;1290;0,462790698;0,537209302
310960;CACHOEIRA DA PRATA;1661;1919;3580;0,46396648;0,53603352
330330;NITEROI;239910;277071;516981;0,464059608;0,535940392
250750;JOAO PESSOA;383251;442545;825796;0,464098882;0,535901118
211130;SAO LUIS;517943;597989;1115932;0,464134911;0,535865089
221140;VARZEA GRANDE;2034;2348;4382;0,464171611;0,535828389
431490;PORTO ALEGRE;692932;799598;1492530;0,464266715;0,535733285
261070;PAULISTA;156870;180049;336919;0,465601524;0,534398476
291480;ITABUNA;99754;114369;214123;0,465872419;0,534127581
431843;SAO JOAO DO POLESINE;1181;1354;2535;0,465877712;0,534122288
230440;FORTALEZA;1259714;1443677;2703391;0,46597551;0,53402449
290980;CRUZ DAS ALMAS;29795;34128;63923;0,466107661;0,533892339
292870;SANTO ANTONIO DE JESUS;48141;55063;103204;0,466464478;0,533535522
150140;BELEM;703310;803110;1506420;0,466875108;0,533124892
330320;NILOPOLIS;76094;86799;162893;0,467141007;0,532858993
220117;BARRA D'ALCANTARA;1847;2106;3953;0,467240071;0,532759929
171320;MIRACEMA DO TOCANTINS;8239;9389;17628;0,467381439;0,532618561
310620;BELO HORIZONTE;1182944;1347757;2530701;0,467437283;0,532562717
351800;GUARANI D'OESTE;934;1062;1996;0,467935872;0,532064128
260790;JABOATAO DOS GUARARAPES;332868;378462;711330;0,467951584;0,532048416
290070;ALAGOINHAS;71634;81389;153023;0,468125707;0,531874293
316480;SAO SEBASTIAO DO RIO PRETO;692;786;1478;0,468200271;0,531799729
220390;FLORIANO;28185;31926;60111;0,468882567;0,531117433
220990;SAO JOAO DA SERRA;2863;3243;6106;0,468883066;0,531116934
431440;PELOTAS;161245;182581;343826;0,468972678;0,531027322
220710;OLHO D'AGUA DO PIAUI;1162;1315;2477;0,469115866;0,530884134
354120;PRESIDENTE BERNARDES;6072;6871;12943;0,469133895;0,530866105
291080;FEIRA DE SANTANA;292811;331296;624107;0,469167947;0,530832053
220020;AGUA BRANCA;8223;9302;17525;0,469215407;0,530784593
291360;ILHEUS;73987;83652;157639;0,469344515;0,530655485
240810;NATAL;421007;475701;896708;0,469502893;0,530497107
320530;VITORIA;173516;196018;369534;0,469553546;0,530446454
292860;SANTO AMARO;28267;31923;60190;0,469629507;0,530370493
220720;PADRE MARCOS;3232;3647;6879;0,469835732;0,530164268
353450;OSCAR BRESSANE;1223;1380;2603;0,469842489;0,530157511
260120;ARCOVERDE;35380;39915;75295;0,469885119;0,530114881
250320;CABEDELO;32788;36985;69773;0,469923896;0,530076104
310980;CACHOEIRA DOURADA;1279;1441;2720;0,470220588;0,529779412
270630;PALMEIRA DOS INDIOS;34553;38899;73452;0,470416054;0,529583946
313670;JUIZ DE FORA;271881;305651;577532;0,470763525;0,529236475
210820;PEDREIRAS;18434;20719;39153;0,470819605;0,529180395
250400;CAMPINA GRANDE;194857;218973;413830;0,470862431;0,529137569
251207;POCO DE JOSE DE MOURA;2056;2310;4366;0,47091159;0,52908841
314120;MATUTINA;1758;1975;3733;0,470934905;0,529065095
510370;FELIZ NATAL;6992;7855;14847;0,47093689;0,52906311
260545;FERNANDO DE NORONHA;1479;1661;3140;0,471019108;0,528980892
330290;MIGUEL PEREIRA;12069;13553;25622;0,471040512;0,528959488
260950;NAZARE DA MATA;15395;17278;32673;0,471184158;0,528815842
280250;GENERAL MAYNARD;1612;1809;3421;0,471207249;0,528792751
316370;SAO LOURENCO;21934;24605;46539;0,471303638;0,528696362
220060;ANGICAL DO PIAUI;3195;3584;6779;0,471308453;0,528691547
330455;RIO DE JANEIRO;3194114;3581447;6775561;0,471416906;0,528583094
260345;CAMARAGIBE;75449;84496;159945;0,471718403;0,528281597
291992;MADRE DE DEUS;10264;11490;21754;0,471821274;0,528178726
220700;OEIRAS;17524;19614;37138;0,471861705;0,528138295
292830;SANTANOPOLIS;4241;4746;8987;0,471903861;0,528096139
260400;CARPINA;40175;44956;85131;0,471919747;0,528080253
311620;CHIADOR;1254;1403;2657;0,471960858;0,528039142
220275;COLONIA DO GURGUEIA;3090;3455;6545;0,472116119;0,527883881
330285;MESQUITA;83589;93427;177016;0,472211551;0,527788449
290850;CONCEICAO DO JACUIPE;15883;17748;33631;0,472272606;0,527727394
292630;RIACHAO DO JACUIPE;15822;17676;33498;0,472326706;0,527673294
290890;CORACAO DE MARIA;10576;11815;22391;0,472332634;0,527667366
310040;ACAIACA;1887;2108;3995;0,472340426;0,527659574
432210;TUCUNDUVA;2651;2961;5612;0,472380613;0,527619387
260600;GARANHUNS;66774;74573;141347;0,472411866;0,527588134
310320;ARACAI;1115;1245;2360;0,472457627;0,527542373
291450;IRARA;13846;15459;29305;0,472479099;0,527520901
291160;GOVERNADOR MANGABEIRA;9828;10972;20800;0,4725;0,5275
260005;ABREU E LIMA;47582;53116;100698;0,472521798;0,527478202
240325;PARNAMIRIM;128837;143653;272490;0,472813681;0,527186319
210120;BACABAL;49691;55403;105094;0,472824329;0,527175671
250180;BAYEUX;46115;51404;97519;0,472882208;0,527117792
230900;MUCAMBO;6886;7675;14561;0,472907081;0,527092919
211120;SAO JOSE DE RIBAMAR;85296;95049;180345;0,47296016;0,52703984
270030;ARAPIRACA;110825;123484;234309;0,472986526;0,527013474
292230;MURITIBA;13916;15504;29420;0,473011557;0,526988443
292880;SANTO ESTEVAO;25392;28274;53666;0,473148735;0,526851265
251274;RIACHAO;1727;1923;3650;0,473150685;0,526849315
220800;PICOS;37203;41424;78627;0,473158075;0,526841925
290650;CANDEIAS;41555;46265;87820;0,473183785;0,526816215
520060;ALTO PARAISO DE GOIAS;3668;4083;7751;0,473229261;0,526770739
314470;NOVA ERA;8293;9231;17524;0,473236704;0,526763296
150080;ANANINDEUA;255781;284629;540410;0,473309154;0,526690846
280520;PINHAO;3162;3516;6678;0,473495058;0,526504942
220220;CAMPO MAIOR;22237;24713;46950;0,473631523;0,526368477
330490;SAO GONCALO;520403;577954;1098357;0,473801323;0,526198677
431643;SALDANHA MARINHO;1230;1366;2596;0,473805855;0,526194145
230730;JUAZEIRO DO NORTE;131857;146407;278264;0,473855763;0,526144237
352960;MERIDIANO;1807;2006;3813;0,473905062;0,526094938
250120;AREIAL;3343;3711;7054;0,473915509;0,526084491
431710;SANT'ANA DO LIVRAMENTO;35853;39794;75647;0,473951379;0,526048621
260500;CUPIRA;11488;12749;24237;0,473986054;0,526013946
411570;MATINHOS;16925;18780;35705;0,474023246;0,525976754
220780;PAULISTANA;9758;10825;20583;0,474080552;0,525919448
291860;JUSSIAPE;2739;3038;5777;0,474121516;0,525878484
330390;PETROPOLIS;145659;161485;307144;0,47423684;0,52576316
312370;ENGENHEIRO CALDAS;5346;5922;11268;0,474440895;0,525559105
330510;SAO JOAO DE MERITI;224594;248791;473385;0,474442578;0,525557422
251080;PATOS;51608;57158;108766;0,474486512;0,525513488
230420;CRATO;63543;70370;133913;0,47450957;0,52549043
330150;CORDEIRO;10515;11637;22152;0,474674973;0,525325027
312770;GOVERNADOR VALADARES;133946;148218;282164;0,474709743;0,525290257
270240;DELMIRO GOUVEIA;24925;27576;52501;0,474752862;0,525247138
355030;SAO PAULO;5885375;6510997;12396372;0,474765923;0,525234077
330620;VASSOURAS;17694;19568;37262;0,474853738;0,525146262
411721;NOVA SANTA BARBARA;2044;2260;4304;0,474907063;0,525092937
251600;SOLANEA;12372;13679;26051;0,474914591;0,525085409
420200;BALNEARIO CAMBORIU;70881;78346;149227;0,47498777;0,52501223
270510;MATRIZ DE CAMARAGIBE;11698;12929;24627;0,475007106;0,524992894
240310;CURRAIS NOVOS;21391;23631;45022;0,475123273;0,524876727
260410;CARUARU;175490;193853;369343;0,475140994;0,524859006
410690;CURITIBA;933079;1030647;1963726;0,47515743;0,52484257
431690;SANTA MARIA;135527;149632;285159;0,475268184;0,524731816
280610;ROSARIO DO CATETE;5304;5854;11158;0,475354006;0,524645994
260880;LAJEDO;19435;21448;40883;0,475380965;0,524619035
522100;TAQUARAL DE GOIAS;1667;1839;3506;0,475470622;0,524529378
317210;VOLTA GRANDE;2506;2764;5270;0,475521822;0,524478178
230480;GRANJEIRO;2275;2509;4784;0,475543478;0,524456522
292400;PAULO AFONSO;56695;62518;119213;0,475577328;0,524422672
330187;IGUABA GRANDE;13956;15388;29344;0,475599782;0,524400218
291750;JACOBINA;38410;42339;80749;0,475671525;0,524328475
270690;PILAR;16796;18514;35310;0,475672614;0,524327386
432160;TRAMANDAI;25452;28055;53507;0,47567608;0,52432392
240600;JOSE DA PENHA;2826;3115;5941;0,475677495;0,524322505
220010;AGRICOLANDIA;2437;2686;5123;0,475697833;0,524302167
310560;BARBACENA;66156;72905;139061;0,475733671;0,524266329
270570;OLHO D'AGUA DAS FLORES;10321;11369;21690;0,475841402;0,524158598
330630;VOLTA REDONDA;130858;144067;274925;0,475977085;0,524022915
430470;CARAZINHO;29713;32700;62413;0,47607069;0,52392931
270620;PALESTINA;2410;2651;5061;0,476190476;0,523809524
330340;NOVA FRIBURGO;91269;100395;191664;0,476192712;0,523807288
251580;SERRA REDONDA;3334;3667;7001;0,476217683;0,523782317
313620;JOAO MONLEVADE;38537;42366;80903;0,476335859;0,523664141
430610;CRUZ ALTA;28372;31189;59561;0,476351975;0,523648025
330580;TERESOPOLIS;88516;97304;185820;0,47635346;0,52364654
290490;CACHOEIRA;16035;17624;33659;0,476395615;0,523604385
520870;GOIANIA;741228;814398;1555626;0,476482136;0,523517864
261640;VITORIA DE SANTO ANTAO;66898;73491;140389;0,476518816;0,523481184
316750;SIMAO PEREIRA;1249;1372;2621;0,476535673;0,523464327
293330;VITORIA DA CONQUISTA;163796;179847;343643;0,476645821;0,523354179
220995;SAO JOAO DA VARJOTA;2315;2541;4856;0,476729819;0,523270181
410830;FOZ DO IGUACU;122988;134983;257971;0,476751263;0,523248737
291460;IRECE;35305;38745;74050;0,476772451;0,523227549
312250;DOM CAVATI;2396;2629;5025;0,47681592;0,52318408
260010;AFOGADOS DA INGAZEIRA;17904;19642;37546;0,476855058;0,523144942
293170;TERRA NOVA;6208;6810;13018;0,476878169;0,523121831
330600;TRES RIOS;39330;43138;82468;0,476912257;0,523087743
230550;IGUATU;49424;54209;103633;0,476913724;0,523086276
260190;BEZERROS;29075;31885;60960;0,4769521;0,5230479
431033;IMBE;11315;12406;23721;0,477003499;0,522996501
220770;PARNAIBA;73395;80468;153863;0,477015267;0,522984733
292670;RIO DE CONTAS;6144;6734;12878;0,477092716;0,522907284
350060;AGUAS DE SAO PEDRO;1712;1876;3588;0,477146042;0,522853958
290830;CONCEICAO DO ALMEIDA;8153;8934;17087;0,477146369;0,522853631
291020;DOM MACEDO COSTA;1943;2129;4072;0,4771611;0,5228389
355280;TABOAO DA SERRA;141988;155540;297528;0,477225673;0,522774327
220050;AMARANTE;8404;9205;17609;0,477255949;0,522744051
410240;BANDEIRANTES;14826;16235;31061;0,477318824;0,522681176
290730;CASTRO ALVES;12587;13782;26369;0,477340817;0,522659183
352780;LUPERCIO;2200;2408;4608;0,477430556;0,522569444
210380;DOM PEDRO;11170;12223;23393;0,477493267;0,522506733
291800;JEQUIE;74624;81653;156277;0,477511086;0,522488914
352210;ITANHAEM;49833;54518;104351;0,477551724;0,522448276
210675;MIRANDA DO NORTE;13907;15214;29121;0,47755915;0,52244085
292975;SAUBARA;5809;6354;12163;0,477595988;0,522404012
310690;BICAS;6979;7633;14612;0,477621133;0,522378867
251365;JOCA CLAUDINO;1261;1379;2640;0,477651515;0,522348485
293140;TEODORO SAMPAIO;3485;3811;7296;0,477658991;0,522341009
315390;RAPOSOS;7883;8618;16501;0,477728623;0,522271377
290800;COARACI;7706;8422;16128;0,477802579;0,522197421
412635;SERRANOPOLIS DO IGUACU;2131;2329;4460;0,477802691;0,522197309
261450;SURUBIM;31628;34564;66192;0,477822093;0,522177907
330030;BARRA DO PIRAI;48332;52807;101139;0,477876981;0,522123019
292920;SAO FRANCISCO DO CONDE;19434;21230;40664;0,477916585;0,522083415
250355;CACIMBAS;3453;3772;7225;0,477923875;0,522076125
260680;IGARASSU;57208;62482;119690;0,477968084;0,522031916
330350;NOVA IGUACU;394511;430877;825388;0,477970361;0,522029639
350250;APARECIDA;17309;18902;36211;0,478003921;0,521996079
311205;CANTAGALO;2187;2388;4575;0,478032787;0,521967213
251370;SANTA RITA;66013;72080;138093;0,47803292;0,52196708
354100;PRAIA GRANDE;160846;175608;336454;0,47806238;0,52193762
220140;BARRO DURO;3357;3665;7022;0,478068926;0,521931074
260620;GOIANA;38411;41934;80345;0,478075798;0,521924202
315670;SABARA;65916;71961;137877;0,478078287;0,521921713
431410;PASSO FUNDO;98537;107566;206103;0,478095904;0,521904096
270020;ANADIA;8371;9136;17507;0,478151597;0,521848403
290110;AMELIA RODRIGUES;11954;13043;24997;0,478217386;0,521782614
260340;CALUMBI;2747;2997;5744;0,478238162;0,521761838
260170;BELO JARDIM;36792;40138;76930;0,478252957;0,521747043
315733;SANTA CRUZ DE MINAS;4172;4551;8723;0,478275823;0,521724177
270480;MARIBONDO;6277;6846;13123;0,478320506;0,521679494
291920;LAURO DE FREITAS;97898;106771;204669;0,478323537;0,521676463
355100;SAO VICENTE;177393;193446;370839;0,478355836;0,521644164
220271;COCAL DE TELHA;2348;2560;4908;0,478402608;0,521597392
430910;GRAMADO;17636;19228;36864;0,478407118;0,521592882
522028;SAO PATRICIO;976;1064;2040;0,478431373;0,521568627
210860;PINHEIRO;40272;43888;84160;0,47851711;0,52148289
210530;IMPERATRIZ;124408;135572;259980;0,478529118;0,521470882
500200;BATAYPORA;5440;5928;11368;0,478536242;0,521463758
291190;IACU;11461;12489;23950;0,478538622;0,521461378
210990;SANTA INES;43036;46891;89927;0,478565948;0,521434052
270915;TEOTONIO VILELA;21331;23239;44570;0,478595468;0,521404532
220410;FRANCISCO AYRES;2058;2242;4300;0,478604651;0,521395349
316250;SAO JOAO DEL REI;43508;47389;90897;0,478651661;0,521348339
260850;LAGOA DE ITAENGA;10288;11202;21490;0,478734295;0,521265705
261230;SALOA;7603;8277;15880;0,478778338;0,521221662
432230;TUPARENDI;3701;4029;7730;0,478783959;0,521216041
250880;MALTA;2751;2994;5745;0,478851175;0,521148825
261530;TIMBAUBA;25184;27403;52587;0,47890163;0,52109837
230080;ANTONINA DO NORTE;3545;3857;7402;0,478924615;0,521075385
521540;OURO VERDE DE GOIAS;1762;1917;3679;0,478934493;0,521065507
411370;LONDRINA;278199;302671;580870;0,478935046;0,521064954
353440;OSASCO;335944;365484;701428;0,478942956;0,521057044
410860;GOIOERE;13762;14972;28734;0,478944804;0,521055196
313840;LEOPOLDINA;25239;27451;52690;0,4790093;0,5209907
430770;ESTEIO;39930;43422;83352;0,479052692;0,520947308
430545;CIDREIRA;8098;8799;16897;0,479256673;0,520743327
311080;CAMPANARIO;1792;1947;3739;0,479272533;0,520727467
520680;DAMOLANDIA;1411;1533;2944;0,479279891;0,520720109
251210;POMBAL;15722;17081;32803;0,479285431;0,520714569
312100;DATAS;2603;2828;5431;0,479285583;0,520714417
251270;REMIGIO;9573;10400;19973;0,479297051;0,520702949
432050;SERTAO;2502;2718;5220;0,479310345;0,520689655
290100;AMARGOSA;18037;19594;37631;0,479312269;0,520687731
270930;UNIAO DOS PALMARES;31620;34343;65963;0,479359641;0,520640359
520005;ABADIA DE GOIAS;4390;4768;9158;0,479362306;0,520637694
522005;SAO JOAO DA PARAUNA;629;683;1312;0,479420732;0,520579268
421660;SAO JOSE;121633;132072;253705;0,479426893;0,520573107
291550;ITAJUIPE;9737;10572;20309;0,479442612;0,520557388
270670;PENEDO;30687;33318;64005;0,479446918;0,520553082
210300;CAXIAS;79682;86477;166159;0,479552718;0,520447282
250680;INGA;8721;9463;18184;0,479597448;0,520402552
312600;FLORESTAL;3646;3956;7602;0,479610629;0,520389371
230320;CARIRIACU;12954;14054;27008;0,479635664;0,520364336
330412;QUATIS;6985;7577;14562;0,479673122;0,520326878
261340;SAO JOSE DA COROA GRANDE;10490;11378;21868;0,47969636;0,52030364
110015;OURO PRETO DO OESTE;17004;18441;35445;0,479729158;0,520270842
431680;SANTA CRUZ DO SUL;63461;68810;132271;0,479780148;0,520219852
412085;QUATRO PONTES;1940;2103;4043;0,479841702;0,520158298
250130;AROEIRAS;9156;9925;19081;0,479849065;0,520150935
292960;SAPEACU;8360;9061;17421;0,479880604;0,520119396
261570;TRIUNFO;7311;7921;15232;0,479976366;0,520023634
291210;IBICARAI;10120;10963;21083;0,480007589;0,519992411
430160;BAGE;58331;63187;121518;0,480019421;0,519980579
430950;GUARANI DAS MISSOES;3549;3844;7393;0,480048695;0,519951305
431127;LAGOA DOS TRES CANTOS;770;834;1604;0,480049875;0,519950125
430460;CANOAS;167899;181829;349728;0,480084523;0,519915477
354780;SANTO ANDRE;347543;376346;723889;0,480105375;0,519894625
293010;SENHOR DO BONFIM;38320;41493;79813;0,480122286;0,519877714
220330;DEMERVAL LOBAO;6656;7206;13862;0,480161593;0,519838407
250370;CAJAZEIRAS;30048;32528;62576;0,480184096;0,519815904
430540;CHIAPETTA;1769;1915;3684;0,480184582;0,519815418
292595;RAFAEL JAMBEIRO;10874;11769;22643;0,480236718;0,519763282
500568;MUNDO NOVO;8922;9656;18578;0,480245452;0,519754548
292510;POCOES;22518;24367;46885;0,48028154;0,51971846
430300;CACHOEIRA DO SUL;39168;42384;81552;0,480282519;0,519717481
412430;SANTO ANTONIO DO PARAISO;976;1056;2032;0,480314961;0,519685039
250970;MONTEIRO;16157;17481;33638;0,480319876;0,519680124
330280;MENDES;8973;9708;18681;0,480327606;0,519672394
330370;PARAIBA DO SUL;21492;23249;44741;0,480364766;0,519635234
292950;SAO SEBASTIAO DO PASSE;21404;23150;44554;0,4804058;0,5195942
250090;ARARA;6540;7073;13613;0,480423125;0,519576875
150503;NOVO PROGRESSO;12382;13387;25769;0,480499825;0,519500175
411915;PINHAIS;64767;70021;134788;0,480510134;0,519489866
280160;CEDRO DE SAO JOAO;2849;3080;5929;0,480519481;0,519480519
330020;ARARUAMA;65404;70705;136109;0,480526637;0,519473363
292430;PIATA;8099;8755;16854;0,480538745;0,519461255
351840;GUARATINGUETA;59200;63992;123192;0,480550685;0,519449315
313170;ITABIRA;58492;63225;121717;0,480557358;0,519442642
220100;ARRAIAL;2265;2448;4713;0,480585614;0,519414386
530010;BRASILIA;1487195;1607130;3094325;0,480620168;0,519379832
260640;GRAVATA;41007;44302;85309;0,480687852;0,519312148
260845;LAGOA DO CARRO;8859;9570;18429;0,480709751;0,519290249
290820;CONCEICAO DA FEIRA;11026;11907;22933;0,480791872;0,519208128
353980;POA;57328;61893;119221;0,480854883;0,519145117
330610;VALENCA;37125;40077;77202;0,480881324;0,519118676
316860;TEOFILO OTONI;67939;73330;141269;0,480919381;0,519080619
431507;PORTO VERA CRUZ;605;653;1258;0,480922099;0,519077901
351380;DIADEMA;206612;222938;429550;0,480996392;0,519003608
260030;AGRESTINA;12141;13099;25240;0,481022187;0,518977813
231400;VARZEA ALEGRE;19760;21318;41078;0,481036078;0,518963922
293220;UBAITABA;8970;9677;18647;0,481042527;0,518957473
230060;ALTANEIRA;3710;4002;7712;0,481068465;0,518931535
314480;NOVA LIMA;46847;50531;97378;0,481084023;0,518915977
292750;SANTA BARBARA;10089;10882;20971;0,481092938;0,518907062
251392;SAO BENTINHO;2214;2388;4602;0,481095176;0,518904824
430870;GAURAMA;2621;2826;5447;0,481182302;0,518817698
250940;MOGEIRO;6370;6868;13238;0,481190512;0,518809488
240110;AREIA BRANCA;13549;14607;28156;0,48121182;0,51878818
411150;IVAIPORA;15345;16541;31886;0,481245688;0,518754312
261390;SERRA TALHADA;42094;45373;87467;0,481255788;0,518744212
315860;SANTANA DO DESERTO;1918;2067;3985;0,481304893;0,518695107
292930;SAO GONCALO DOS CAMPOS;18442;19873;38315;0,481325851;0,518674149
211220;TIMON;82463;88854;171317;0,481347444;0,518652556
315780;SANTA LUZIA;106731;114974;221705;0,481409982;0,518590018
230690;JAGUARIBE;16653;17939;34592;0,481411887;0,518588113
230210;BATURITE;17393;18734;36127;0,481440474;0,518559526
241250;SAO MIGUEL;11453;12336;23789;0,481441002;0,518558998
220460;HUGO NAPOLEAO;1868;2012;3880;0,481443299;0,518556701
412065;QUARTO CENTENARIO;2128;2292;4420;0,481447964;0,518552036
270520;MESSIAS;8763;9438;18201;0,481457063;0,518542937
420540;FLORIANOPOLIS;248697;267827;516524;0,481481983;0,518518017
430310;CACHOEIRINHA;63626;68518;132144;0,48148989;0,51851011
431740;SANTIAGO;23737;25561;49298;0,481500264;0,518499736
211050;SAO BENTO;22144;23845;45989;0,481506447;0,518493553
320240;GUARAPARI;61878;66626;128504;0,481525867;0,518474133
330170;DUQUE DE CAXIAS;447559;481890;929449;0,481531531;0,518468469
280480;NOSSA SENHORA DO SOCORRO;90400;97333;187733;0,481534946;0,518465054
354980;SAO JOSE DO RIO PRETO;225926;243247;469173;0,481540924;0,518459076
270910;TAQUARANA;9709;10453;20162;0,481549449;0,518450551
500270;CAMPO GRANDE;441122;474879;916001;0,48157371;0,51842629
315210;PONTE NOVA;28896;31107;60003;0,481575921;0,518424079
230190;BARBALHA;29698;31964;61662;0,481625637;0,518374363
260440;CHA DE ALEGRIA;6571;7070;13641;0,481709552;0,518290448
220840;PIRIPIRI;30748;33081;63829;0,481724608;0,518275392
431560;RIO GRANDE;102556;110325;212881;0,481752716;0,518247284
320310;JERONIMO MONTEIRO;5943;6393;12336;0,4817607;0,5182393
210330;CODO;59436;63932;123368;0,481778095;0,518221905
291910;LAMARAO;3892;4186;8078;0,481802426;0,518197574
315180;POCOS DE CALDAS;81829;88009;169838;0,481806192;0,518193808
172085;SUCUPIRA;967;1040;2007;0,481813652;0,518186348
220557;LAGOA DE SAO FRANCISCO;3274;3521;6795;0,481824871;0,518175129
316530;SAO VICENTE DE MINAS;3795;4081;7876;0,481843575;0,518156425
230765;MARACANAU;111301;119685;230986;0,481851714;0,518148286
210600;LIMA CAMPOS;5755;6188;11943;0,481872226;0,518127774
240480;IPUEIRA;1091;1173;2264;0,481890459;0,518109541
290750;CATU;26611;28611;55222;0,481891275;0,518108725
260540;FEIRA NOVA;10776;11584;22360;0,481932021;0,518067979
310600;BELA VISTA DE MINAS;4949;5320;10269;0,481935924;0,518064076
250060;ALHANDRA;9574;10291;19865;0,481953184;0,518046816
330070;CABO FRIO;112823;121254;234077;0,481990969;0,518009031
292130;MILAGRES;5224;5614;10838;0,482007751;0,517992249
311220;CAPELA NOVA;2225;2391;4616;0,482019064;0,517980936
251340;SANTA LUZIA;7457;8013;15470;0,482029735;0,517970265
270770;RIO LARGO;36472;39190;75662;0,48203854;0,51796146
410280;BELA VISTA DO PARAISO;7424;7976;15400;0,482077922;0,517922078
270100;BOCA DA MATA;13223;14206;27429;0,482081009;0,517918991
352900;MARILIA;116787;125462;242249;0,482094869;0,517905131
411995;PONTAL DO PARANA;13754;14775;28529;0,482105927;0,517894073
330040;BARRA MANSA;89304;95933;185237;0,482106707;0,517893293
220735;PAJEU DO PIAUI;1647;1769;3416;0,482142857;0,517857143
354140;PRESIDENTE PRUDENTE;111836;120117;231953;0,482149401;0,517850599
410110;ANDIRA;9558;10265;19823;0,48216718;0,51783282
350950;CAMPINAS;589827;633410;1223237;0,482185382;0,517814618
220750;PALMEIRAIS;7056;7577;14633;0,482197772;0,517802228
251380;SANTA TERESINHA;2194;2356;4550;0,482197802;0,517802198
431340;NOVO HAMBURGO;119249;128054;247303;0,482197952;0,517802048
221097;TANQUE DO PIAUI;1341;1440;2781;0,482200647;0,517799353
311940;CORONEL FABRICIANO;53390;57319;110709;0,482255282;0,517744718
251130;PIANCO;7787;8360;16147;0,482256766;0,517743234
431750;SANTO ANGELO;37399;40145;77544;0,482293923;0,517706077
280210;ESTANCIA;33722;36197;69919;0,482300948;0,517699052
312270;DOM SILVERIO;2521;2706;5227;0,482303425;0,517696575
316870;TIMOTEO;44020;47248;91268;0,482315817;0,517684183
350570;BARUERI;134911;144793;279704;0,482334897;0,517665103
260460;CONDADO;12906;13849;26755;0,482377126;0,517622874
350530;BARRA BONITA;17426;18699;36125;0,482380623;0,517619377
292730;SALINAS DA MARGARIDA;7741;8306;16047;0,482395463;0,517604537
231120;POTENGI;5386;5779;11165;0,482400358;0,517599642
270310;IGACI;12348;13248;25596;0,482419128;0,517580872
430060;ALVORADA;102458;109894;212352;0,482491335;0,517508665
231310;TABULEIRO DO NORTE;15478;16601;32079;0,482496337;0,517503663
350320;ARARAQUARA;116061;124481;240542;0,482497859;0,517502141
220260;CASTELO DO PIAUI;9513;10203;19716;0,482501522;0,517498478
431100;JAGUARAO;12703;13624;26327;0,482508451;0,517491549
431303;NOVA ESPERANCA DO SUL;2637;2828;5465;0,48252516;0,51747484
261370;SAO LOURENCO DA MATA;55447;59463;114910;0,482525455;0,517474545
251593;SERTAOZINHO;2486;2666;5152;0,482531056;0,517468944
240570;JARDIM DO SERIDO;5982;6415;12397;0,482536097;0,517463903
313960;MANTENA;13344;14307;27651;0,482586525;0,517413475
317130;VICOSA;38565;41345;79910;0,482605431;0,517394569
354910;SAO JOAO DA BOA VISTA;44553;47762;92315;0,482619293;0,517380707
316160;SAO GERALDO DA PIEDADE;1863;1997;3860;0,482642487;0,517357513
330245;MACUCO;2725;2921;5646;0,482642579;0,517357421
352042;ILHA COMPRIDA;5576;5976;11552;0,482686981;0,517313019
330414;QUEIMADOS;73519;78792;152311;0,482690022;0,517309978
250540;DESTERRO;4022;4310;8332;0,482717235;0,517282765
314330;MONTES CLAROS;201525;215953;417478;0,482720048;0,517279952
291630;ITAPEBI;4911;5262;10173;0,482748452;0,517251548
270860;SAO MIGUEL DOS CAMPOS;30089;32239;62328;0,482752535;0,517247465
291960;MACAJUBA;5464;5854;11318;0,482770808;0,517229192
315750;SANTA EFIGENIA DE MINAS;2102;2252;4354;0,48277446;0,51722554
290400;BONINAL;7009;7509;14518;0,482779997;0,517220003
280290;ITABAIANA;46752;50087;96839;0,482780698;0,517219302
521580;PALMELO;1150;1232;2382;0,482787573;0,517212427
354870;SAO BERNARDO DO CAMPO;410310;439564;849874;0,482789213;0,517210787
270800;SANTANA DO IPANEMA;23131;24779;47910;0,482801085;0,517198915
410920;GUARACI;2683;2874;5557;0,482814468;0,517185532
261550;TRACUNHAEM;6690;7166;13856;0,482823326;0,517176674
432180;TRES DE MAIO;11514;12332;23846;0,482848276;0,517151724
293290;VALENCA;47258;50615;97873;0,482850224;0,517149776
320520;VILA VELHA;245628;263027;508655;0,482897052;0,517102948
354323;RIBEIRAO DOS INDIOS;1073;1149;2222;0,48289829;0,51710171
411460;MARECHAL CANDIDO RONDON;26092;27939;54031;0,48290796;0,51709204
292520;POJUCA;19510;20891;40401;0,482908839;0,517091161
292720;RUY BARBOSA;14922;15978;30900;0,482912621;0,517087379
310590;BARROSO;10132;10849;20981;0,482913112;0,517086888
351330;CRUZALIA;976;1045;2021;0,482929243;0,517070757
313130;IPATINGA;129108;138225;267333;0,482948233;0,517051767
317120;VESPASIANO;63682;68167;131849;0,482991907;0,517008093
312550;SAO GONCALO DO RIO PRETO;1535;1643;3178;0,483008181;0,516991819
500315;CORONEL SAPUCAIA;7462;7987;15449;0,483008609;0,516991391
312160;DIAMANTINA;23148;24776;47924;0,483014773;0,516985227
430930;GUAIBA;47496;50835;98331;0,483021631;0,516978369
313270;ITAMBACURI;11210;11997;23207;0,483043909;0,516956091
410640;CORNELIO PROCOPIO;23109;24731;47840;0,483047659;0,516952341
291530;ITAGIMIRIM;3277;3507;6784;0,483048349;0,516951651
150215;CANAA DOS CARAJAS;18889;20214;39103;0,483057566;0,516942434
270710;PIRANHAS;12233;13091;25324;0,483059548;0,516940452
330395;PINHEIRAL;12349;13214;25563;0,483081016;0,516918984
420205;BALNEARIO BARRA DO SUL;5445;5826;11271;0,483098217;0,516901783
150405;MAE DO RIO;14681;15708;30389;0,483102438;0,516897562
351540;FARTURA;7779;8323;16102;0,483107688;0,516892312
432130;TAQUARI;12999;13908;26907;0,483108485;0,516891515
351500;EMBU DAS ARTES;134916;144348;279264;0,483112754;0,516887246
270890;SATUBA;6784;7258;14042;0,483122062;0,516877938
315470;RIBEIRAO VERMELHO;1962;2099;4061;0,483132233;0,516867767
432240;URUGUAIANA;61247;65519;126766;0,483150056;0,516849944
431260;MUCUM;2400;2567;4967;0,483189048;0,516810952
410630;CORBELIA;8293;8869;17162;0,483218739;0,516781261
220935;SANTANA DO PIAUI;2247;2403;4650;0,483225806;0,516774194
220430;FRONTEIRAS;5649;6041;11690;0,483233533;0,516766467
432150;TORRES;19032;20349;39381;0,483278738;0,516721262
260910;MACHADOS;7998;8551;16549;0,483292042;0,516707958
210400;ESPERANTINOPOLIS;8202;8769;16971;0,483295033;0,516704967
292250;NAZARE;13852;14809;28661;0,483304839;0,516695161
210340;COELHO NETO;24071;25733;49804;0,483314593;0,516685407
270730;PORTO CALVO;13210;14121;27331;0,483333943;0,516666057
411840;PARANAVAI;43237;46217;89454;0,483343394;0,516656606
210750;PACO DO LUMIAR;60547;64718;125265;0,483351295;0,516648705
261120;POCAO;5466;5842;11308;0,483374602;0,516625398
240230;CARAUBAS;9952;10636;20588;0,483388382;0,516611618
220960;SAO FELIX DO PIAUI;1413;1510;2923;0,483407458;0,516592542
430467;CAPIVARI DO SUL;2317;2476;4793;0,483413311;0,516586689
291470;ITABERABA;31324;33471;64795;0,483432364;0,516567636
251620;SOUSA;33840;36157;69997;0,483449291;0,516550709
430215;BOA VISTA DAS MISSOES;1009;1078;2087;0,483469094;0,516530906
291330;ICHU;3013;3219;6232;0,483472401;0,516527599
241490;VICOSA;837;894;1731;0,483535529;0,516464471
353760;PERUIBE;33702;35995;69697;0,483550225;0,516449775
354340;RIBEIRAO PRETO;348216;371900;720116;0,483555427;0,516444573
410880;GUAIRA;16198;17299;33497;0,483565692;0,516434308
221020;SAO JOSE DO PIAUI;3238;3458;6696;0,483572282;0,516427718
210910;PRESIDENTE DUTRA;23341;24923;48264;0,483610973;0,516389027
421080;MELEIRO;3380;3609;6989;0,483617113;0,516382887
231030;PARAMBU;15182;16209;31391;0,483641808;0,516358192
230270;CAMPOS SALES;13308;14205;27513;0,483698615;0,516301385
312760;GOUVEIA;5713;6098;11811;0,483701634;0,516298366
431036;IMIGRANTE;1501;1602;3103;0,483725427;0,516274573
352720;LORENA;43310;46222;89532;0,483737658;0,516262342
311860;CONTAGEM;325974;347875;673849;0,483749327;0,516250673
350550;BARRETOS;59766;63780;123546;0,483755039;0,516244961
280100;CAMPO DO BRITO;8865;9460;18325;0,483765348;0,516234652
241300;SAO VICENTE;3133;3343;6476;0,483786288;0,516213712
220520;JAICOS;9305;9928;19233;0,483803879;0,516196121
420395;CAPIVARI DE BAIXO;12326;13151;25477;0,483808926;0,516191074
293060;SERROLANDIA;6527;6963;13490;0,483839881;0,516160119
290870;CONDEUBA;8280;8833;17113;0,483842693;0,516157307
291840;JUAZEIRO;106228;113316;219544;0,48385745;0,51614255
171865;RIO DA CONCEICAO;1070;1141;2211;0,483943917;0,516056083
431365;PALMARES DO SUL;5489;5853;11342;0,483953447;0,516046553
261020;PANELAS;12796;13642;26438;0,484000303;0,515999697
251360;SANTANA DOS GARROTES;3360;3582;6942;0,484010372;0,515989628
411520;MARINGA;211259;225213;436472;0,484015011;0,515984989
412810;UMUARAMA;54896;58520;113416;0,484023418;0,515976582
310110;AIMORES;12157;12959;25116;0,484034082;0,515965918
210550;JOAO LISBOA;11461;12216;23677;0,484056257;0,515943743
260810;JOAO ALFREDO;16250;17320;33570;0,484063152;0,515936848
260940;MORENO;30880;32912;63792;0,484073238;0,515926762
430970;HUMAITA;2281;2431;4712;0,484083192;0,515916808
351060;CARAPICUIBA;196238;209137;405375;0,48409004;0,51590996
251690;UIRAUNA;7434;7922;15356;0,484110445;0,515889555
230950;OROS;10332;11010;21342;0,484115828;0,515884172
410140;APUCARANA;66538;70900;137438;0,484131026;0,515868974
410430;CAMPO MOURAO;46526;49576;96102;0,484131444;0,515868556
430800;FAXINAL DO SOTURNO;3220;3431;6651;0,484137724;0,515862276
292800;SANTALUZ;18254;19450;37704;0,484139614;0,515860386
312850;GUARARA;1818;1937;3755;0,484154461;0,515845539
316850;TEIXEIRAS;5655;6025;11680;0,484160959;0,515839041
330190;ITABORAI;118341;126075;244416;0,484178614;0,515821386
220400;FRANCINOPOLIS;2588;2757;5345;0,484190833;0,515809167
350600;BAURU;184825;196881;381706;0,484207741;0,515792259
311840;CONSELHEIRO PENA;11125;11850;22975;0,48422198;0,51577802
241360;SEVERIANO MELO;844;899;1743;0,484222605;0,515777395
312500;EWBANK DA CAMARA;1904;2028;3932;0,484231943;0,515768057
350610;BEBEDOURO;37583;40029;77612;0,484242128;0,515757872
230540;ICO;33076;35227;68303;0,484253986;0,515746014
270440;MAJOR ISIDORO;9648;10275;19923;0,484264418;0,515735582
270540;MONTEIROPOLIS;3473;3698;7171;0,484311811;0,515688189
231250;SAO JOAO DO JAGUARIBE;3660;3897;7557;0,484319174;0,515680826
315830;SANTANA DA VARGEM;3413;3634;7047;0,484319569;0,515680431
210520;IGARAPE GRANDE;5547;5906;11453;0,484327251;0,515672749
293070;SIMOES FILHO;66412;70705;137117;0,484345486;0,515654514
220210;CAMPINAS DO PIAUI;2726;2902;5628;0,484363895;0,515636105
350280;ARACATUBA;96491;102719;199210;0,484368255;0,515631745
430280;CACAPAVA DO SUL;16215;17261;33476;0,484376867;0,515623133
320110;BOM JESUS DO NORTE;4838;5150;9988;0,484381258;0,515618742
330385;PATY DO ALFERES;13535;14407;27942;0,484396249;0,515603751
353880;PIRAJU;14498;15432;29930;0,484396926;0,515603074
312737;GOIABEIRA;1648;1754;3402;0,484420929;0,515579071
291170;GUANAMBI;41348;44005;85353;0,484435228;0,515564772
211223;TRIZIDELA DO VALE;10766;11457;22223;0,484453044;0,515546956
251398;SAO FRANCISCO;1636;1741;3377;0,484453657;0,515546343
317070;VARGINHA;66665;70943;137608;0,484455846;0,515544154
431346;NOVO XINGU;826;879;1705;0,484457478;0,515542522
270230;CORURIPE;27928;29719;57647;0,4844658;0,5155342
280350;LAGARTO;51361;54654;106015;0,484469179;0,515530821
291610;ITAPARICA;10872;11568;22440;0,484491979;0,515508021
251170;PILOEZINHOS;2392;2545;4937;0,48450476;0,51549524
230390;CHAVAL;6353;6759;13112;0,484517999;0,515482001
251250;QUEIMADAS;21508;22880;44388;0,484545373;0,515454627
410845;FOZ DO JORDAO;2164;2302;4466;0,484549933;0,515450067
250625;GADO BRAVO;4018;4274;8292;0,484563435;0,515436565
315490;RIO CASCA;6486;6898;13384;0,484608488;0,515391512
330045;BELFORD ROXO;249710;265529;515239;0,484648872;0,515351128
310150;ALEM PARAIBA;17175;18263;35438;0,484649247;0,515350753
410650;CORONEL VIVIDA;9902;10528;20430;0,484679393;0,515320607
250630;GUARABIRA;28785;30604;59389;0,484685716;0,515314284
230760;LIMOEIRO DO NORTE;29194;31038;60232;0,484692522;0,515307478
350745;BOREBI;1315;1398;2713;0,484703281;0,515296719
354660;SANTA FE DO SUL;15899;16897;32796;0,48478473;0,51521527
330100;CAMPOS DOS GOYTACAZES;249493;265150;514643;0,484788484;0,515211516
320130;CARIACICA;187370;199125;386495;0,484792818;0,515207182
431670;SANTA BARBARA DO SUL;3788;4025;7813;0,484832971;0,515167029
430680;ENCANTADO;11174;11873;23047;0,484835336;0,515164664
520890;GOIAS;10726;11396;22122;0,484856704;0,515143296
211150;SAO MATEUS DO MARANHAO;20243;21507;41750;0,484862275;0,515137725
411275;JESUITAS;4001;4250;8251;0,48491092;0,51508908
240190;CAICARA DO RIO DO VENTO;1816;1929;3745;0,484913218;0,515086782
210945;RAPOSA;15317;16269;31586;0,484930032;0,515069968
520540;CERES;10866;11541;22407;0,484937743;0,515062257
312980;IBIRITE;89248;94782;184030;0,484964408;0,515035592
412350;SANTA HELENA;13112;13924;27036;0,484982986;0,515017014
411375;LUNARDELLI;2277;2418;4695;0,484984026;0,515015974
231126;QUITERIANOPOLIS;10304;10942;21246;0,484985409;0,515014591
311550;CAXAMBU;10460;11106;21566;0,485022721;0,514977279
280670;SAO CRISTOVAO;44666;47424;92090;0,485025519;0,514974481
354425;ROSANA;7726;8203;15929;0,485027309;0,514972691
315110;PIRAPETINGA;5234;5557;10791;0,485033824;0,514966176
421720;SAO MIGUEL DO OESTE;20007;21239;41246;0,485065218;0,514934782
430700;ERECHIM;52081;55287;107368;0,485070039;0,514929961
313820;LAVRAS;51301;54455;105756;0,485088317;0,514911683
211110;SAO JOAO DOS PATOS;12643;13420;26063;0,485093811;0,514906189
150240;CASTANHAL;99769;105898;205667;0,4850997;0,5149003
430560;COLORADO;1498;1590;3088;0,485103627;0,514896373
353000;MIRA ESTRELA;1516;1609;3125;0,48512;0,51488
354110;PRESIDENTE ALVES;1973;2094;4067;0,48512417;0,51487583
220980;SAO GONCALO DO PIAUI;2447;2597;5044;0,485130849;0,514869151
291400;IPIRA;28760;30521;59281;0,485147012;0,514852988
270790;SANTA LUZIA DO NORTE;3563;3781;7344;0,485157952;0,514842048
270940;VICOSA;12447;13208;25655;0,485168583;0,514831417
316070;SANTOS DUMONT;22491;23866;46357;0,485169446;0,514830554
280360;LARANJEIRAS;14714;15613;30327;0,485178224;0,514821776
432100;TAPERA;5128;5441;10569;0,485192544;0,514807456
261200;SAIRE;4658;4942;9600;0,485208333;0,514791667
310570;BARRA LONGA;2380;2525;4905;0,485219164;0,514780836
353470;OURINHOS;55870;59269;115139;0,48523958;0,51476042
230423;CROATA;8832;9369;18201;0,485248063;0,514751937
410165;ARAPUA;1432;1519;2951;0,485259234;0,514740766
220192;BONFIM DO PIAUI;2766;2934;5700;0,485263158;0,514736842
240120;ARES;7049;7477;14526;0,485267796;0,514732204
351870;GUARUJA;157708;167269;324977;0,485289728;0,514710272
280740;TOBIAS BARRETO;25653;27208;52861;0,485291614;0,514708386
312800;GUANHAES;16897;17921;34818;0,485294962;0,514705038
430580;CONSTANTINA;4806;5097;9903;0,485307483;0,514692517
420930;LAGES;76270;80888;157158;0,485307779;0,514692221
261060;PAUDALHO;27831;29515;57346;0,485317197;0,514682803
314610;OURO PRETO;36315;38509;74824;0,485338929;0,514661071
221038;SAO MIGUEL DA BAIXA GRANDE;1192;1264;2456;0,48534202;0,51465798
354650;SANTA ERNESTINA;2707;2870;5577;0,485386408;0,514613592
410190;ASSAI;7180;7612;14792;0,485397512;0,514602488
290510;CAEM;4326;4586;8912;0,485412926;0,514587074
220887;RIBEIRA DO PIAUI;2184;2315;4499;0,485441209;0,514558791
270820;SAO BRAS;3387;3590;6977;0,4854522;0,5145478
291855;JUSSARI;2770;2936;5706;0,485453908;0,514546092
410980;IBIPORA;27034;28654;55688;0,485454676;0,514545324
430890;GETULIO VARGAS;7844;8314;16158;0,485456121;0,514543879
350900;CAIEIRAS;50509;53535;104044;0,485458075;0,514541925
412180;RIBEIRAO CLARO;5157;5465;10622;0,485501789;0,514498211
411830;PARANAPOEMA;1591;1686;3277;0,485505035;0,514494965
330060;BOM JESUS DO ITABAPOANA;18114;19192;37306;0,485551922;0,514448078
290195;APUAREMA;3532;3742;7274;0,485565026;0,514434974
431910;SAO MARTINHO;2591;2745;5336;0,485569715;0,514430285
330180;ENGENHEIRO PAULO DE FRONTIN;6865;7273;14138;0,485570802;0,514429198
250915;MARIZOPOLIS;3248;3441;6689;0,485573329;0,514426671
231290;SOBRAL;103172;109265;212437;0,485659278;0,514340722
313120;IPANEMA;9778;10355;20133;0,485670293;0,514329707
431080;IVOTI;12175;12893;25068;0,485678953;0,514321047
330250;MAGE;120323;127418;247741;0,48568061;0,51431939
240050;ALEXANDRIA;6571;6958;13529;0,485697391;0,514302609
250190;BELEM;8613;9120;17733;0,485704619;0,514295381
230370;CAUCAIA;179189;189729;368918;0,485714983;0,514285017
421870;TUBARAO;52042;55101;107143;0,485724686;0,514275314
355475;TRABIJU;851;901;1752;0,485730594;0,514269406
353850;PIQUETE;6555;6940;13495;0,485735458;0,514264542
355160;SERRA NEGRA;14412;15257;29669;0,485759547;0,514240453
172100;PALMAS;152217;161132;313349;0,485774647;0,514225353
351880;GUARULHOS;682367;722327;1404694;0,485776262;0,514223738
315600;RIO VERMELHO;6138;6497;12635;0,485793431;0,514206569
211125;SAO JOSE DOS BASILIOS;3711;3928;7639;0,48579657;0,51420343
270080;BELEM;2053;2173;4226;0,485802177;0,514197823
351570;FERRAZ DE VASCONCELOS;96515;102146;198661;0,485827616;0,514172384
410710;DIAMANTE DO NORTE;2417;2558;4975;0,485829146;0,514170854
260310;CACHOEIRINHA;10017;10601;20618;0,485837618;0,514162382
431295;NOVA BOA VISTA;841;890;1731;0,485846332;0,514153668
280760;UMBAUBA;12535;13265;25800;0,485852713;0,514147287
431010;IGREJINHA;18343;19411;37754;0,485855803;0,514144197
430150;AUGUSTO PESTANA;3180;3365;6545;0,485867074;0,514132926
411160;IVATUBA;1603;1696;3299;0,48590482;0,51409518
251070;PASSAGEM;1192;1261;2453;0,485935589;0,514064411
270270;FELIZ DESERTO;2334;2469;4803;0,485946284;0,514053716
412440;SANTO ANTONIO DO SUDOESTE;9891;10463;20354;0,485948708;0,514051292
410370;CAMBE;52544;55582;108126;0,485951575;0,514048425
432000;SAPUCAIA DO SUL;69252;73256;142508;0,485951666;0,514048334
240200;CAICO;33399;35327;68726;0,485973285;0,514026715
312385;ENTRE FOLHAS;2616;2767;5383;0,485974364;0,514025636
241100;RODOLFO FERNANDES;2166;2291;4457;0,485977115;0,514022885
351670;GARCA;21592;22837;44429;0,485988881;0,514011119
230250;BREJO SANTO;24395;25800;50195;0,486004582;0,513995418
353715;PEDRINHAS PAULISTA;1511;1598;3109;0,486008363;0,513991637
314390;MURIAE;53461;56536;109997;0,486022346;0,513977654
351110;CATANDUVA;59837;63277;123114;0,486029209;0,513970791
251010;NOVA FLORESTA;5159;5455;10614;0,486056152;0,513943848
430463;CAPAO DA CANOA;26738;28271;55009;0,486065916;0,513934084
352440;JACAREI;115259;121860;237119;0,486080829;0,513919171
220940;SANTO ANTONIO DE LISBOA;3143;3323;6466;0,486081039;0,513918961
250030;ALAGOA GRANDE;13797;14587;28384;0,486083709;0,513916291
412405;SANTA TEREZINHA DE ITAIPU;11631;12296;23927;0,486103565;0,513896435
280230;FREI PAULO;7626;8062;15688;0,486104029;0,513895971
250690;ITABAIANA;11843;12520;24363;0,48610598;0,51389402
130260;MANAUS;1096615;1159288;2255903;0,48610911;0,51389089
432300;VIAMAO;125101;132229;257330;0,48615008;0,51384992
430440;CANELA;22342;23615;45957;0,486150097;0,513849903
354750;SANTA RITA DO PASSA QUATRO;13438;14203;27641;0,486161861;0,513838139
220090;AROAZES;2829;2990;5819;0,486166008;0,513833992
430380;CAMPINAS DO SUL;2636;2786;5422;0,486167466;0,513832534
316720;SETE LAGOAS;118602;125348;243950;0,486173396;0,513826604
410360;CAMBARA;12431;13138;25569;0,486174665;0,513825335
431140;LAJEADO;41814;44191;86005;0,486181036;0,513818964
221000;SAO JOAO DO PIAUI;10074;10646;20720;0,486196911;0,513803089
420830;ITAPEMA;33705;35618;69323;0,486202271;0,513797729
311830;CONSELHEIRO LAFAIETE;63491;67093;130584;0,486208111;0,513791889
270895;SENADOR RUI PALMEIRA;6755;7138;13893;0,48621608;0,51378392
522185;VALPARAISO DE GOIAS;85441;90279;175720;0,486233781;0,513766219
293280;UTINGA;9399;9931;19330;0,486239007;0,513760993
210850;PINDARE-MIRIM;16137;17049;33186;0,486259266;0,513740734
240800;MOSSORO;147725;156067;303792;0,486270211;0,513729789
352044;ILHA SOLTEIRA;13074;13812;26886;0,486275385;0,513724615
250430;CATOLE DO ROCHA;14987;15832;30819;0,486290924;0,513709076
240770;MONTANHAS;5430;5736;11166;0,486297689;0,513702311
260140;BARREIROS;20846;22020;42866;0,486306163;0,513693837
312690;FREI INOCENCIO;4725;4991;9716;0,486311239;0,513688761
317190;VIRGOLANDIA;2579;2724;5303;0,486328493;0,513671507
291760;JAGUAQUARA;26706;28207;54913;0,486332927;0,513667073
292900;SAO FELIX;7190;7594;14784;0,48633658;0,51366342
270760;QUEBRANGULO;5448;5754;11202;0,486341725;0,513658275
420900;JOACABA;14923;15761;30684;0,486344675;0,513655325
220880;REGENERACAO;8744;9235;17979;0,48634518;0,51365482
354130;PRESIDENTE EPITACIO;21678;22894;44572;0,486359149;0,513640851
250520;CUITEGI;3282;3466;6748;0,486366331;0,513633669
350480;BALSAMO;4479;4730;9209;0,486372027;0,513627973
211176;SENADOR LA ROCQUE;6800;7181;13981;0,486374365;0,513625635
353060;MOGI DAS CRUZES;221586;234001;455587;0,486374721;0,513625279
230015;ACARAPE;7364;7776;15140;0,486393659;0,513606341
240010;ACARI;5402;5704;11106;0,486403746;0,513596254
291050;ENTRE RIOS;20436;21578;42014;0,486409292;0,513590708
411850;PATO BRANCO;41240;43539;84779;0,486441218;0,513558782
220790;PEDRO II;18881;19931;38812;0,486473256;0,513526744
410755;FAROL;1457;1538;2995;0,486477462;0,513522538
210740;OLHO D'AGUA DAS CUNHAS;9543;10073;19616;0,48649062;0,51350938
320150;COLATINA;60464;63819;124283;0,486502579;0,513497421
261050;PASSIRA;14039;14817;28856;0,486519268;0,513480732
241020;PORTALEGRE;3865;4079;7944;0,486530715;0,513469285
292500;PLANALTO;12933;13648;26581;0,486550544;0,513449456
280500;PEDRA MOLE;1610;1699;3309;0,486551828;0,513448172
316340;SAO JOSE DO GOIABAL;2606;2750;5356;0,486557132;0,513442868
431020;IJUI;40892;43149;84041;0,48657203;0,51342797
352070;INDIAPORA;1886;1990;3876;0,486584107;0,513415893
431870;SAO LEOPOLDO;116967;123411;240378;0,486596111;0,513403889
354625;SANTA CRUZ DA ESPERANCA;1054;1112;2166;0,486611265;0,513388735
251240;PUXINANA;6716;7085;13801;0,486631404;0,513368596
250600;ESPERANCA;16248;17138;33386;0,48667106;0,51332894
251310;SALGADO DE SAO FELIX;5900;6223;12123;0,486678215;0,513321785
250920;MASSARANDUBA;6851;7226;14077;0,486680401;0,513319599
521000;INHUMAS;26114;27541;53655;0,486702078;0,513297922
290460;BRUMADO;32837;34631;67468;0,486704808;0,513295192
410550;CIANORTE;41361;43619;84980;0,486714521;0,513285479
521740;PIRES DO RIO;15531;16378;31909;0,486727882;0,513272118
412770;TOLEDO;70382;74219;144601;0,486732457;0,513267543
313375;ITAU DE MINAS;7927;8359;16286;0,486737075;0,513262925
352430;JABOTICABAL;37980;40049;78029;0,486742109;0,513257891
292910;SAO FELIPE;10262;10821;21083;0,486742873;0,513257127
410450;CAPANEMA;9332;9840;19172;0,486751513;0,513248487
270490;MAR VERMELHO;1691;1783;3474;0,48675878;0,51324122
411790;PALOTINA;15766;16623;32389;0,4867702;0,5132298
311265;CAPITAO ANDRADE;2706;2853;5559;0,486778198;0,513221802
290687;CAPIM GROSSO;15117;15938;31055;0,486781517;0,513218483
270200;COITE DO NOIA;5157;5437;10594;0,486784973;0,513215027
220900;RIO GRANDE DO PIAUI;3132;3302;6434;0,486788934;0,513211066
352500;JANDIRA;62181;65553;127734;0,486800695;0,513199305
350750;BOTUCATU;72883;76835;149718;0,486801854;0,513198146
292405;PE DE SERRA;6589;6946;13535;0,486811969;0,513188031
350010;ADAMANTINA;17113;18040;35153;0,486814781;0,513185219
270050;BARRA DE SANTO ANTONIO;7887;8314;16201;0,486821801;0,513178199
430845;FORTALEZA DOS VALOS;2070;2182;4252;0,486829727;0,513170273
316020;SANTO ANTONIO DO ITAMBE;1832;1931;3763;0,486845602;0,513154398
411342;LIDIANOPOLIS;1536;1619;3155;0,486846276;0,513153724
351620;FRANCA;174556;183983;358539;0,486853592;0,513146408
110028;ROLIM DE MOURA;27143;28605;55748;0,486887422;0,513112578
210193;BERNARDO DO MEARIM;2971;3131;6102;0,486889544;0,513110456
290030;ACAJUTIBA;7408;7806;15214;0,486919942;0,513080058
290010;ABAIRA;4227;4454;8681;0,486925469;0,513074531
430110;ARROIO DOS RATOS;6915;7286;14201;0,48693754;0,51306246
250450;CONDADO;3244;3418;6662;0,486940859;0,513059141
250070;SAO JOAO DO RIO DO PEIXE;8775;9245;18020;0,486958935;0,513041065
411095;ITAIPULANDIA;5643;5945;11588;0,486969279;0,513030721
430920;GRAVATAI;139065;146499;285564;0,486983653;0,513016347
280060;BARRA DOS COQUEIROS;15311;16128;31439;0,487006584;0,512993416
411990;PONTA GROSSA;174771;184067;358838;0,48704708;0,51295292
230410;CRATEUS;36647;38594;75241;0,487061575;0,512938425
231110;PORTEIRAS;7267;7653;14920;0,487064343;0,512935657
421003;LUZERNA;2768;2915;5683;0,48706669;0,51293331
412862;ALTO PARAISO;1281;1349;2630;0,487072243;0,512927757
220640;MONSENHOR GIL;5145;5418;10563;0,487077535;0,512922465
316260;SAO JOAO DO ORIENTE;3601;3792;7393;0,487082375;0,512917625
210980;SANTA HELENA;20862;21967;42829;0,487099862;0,512900138
314560;OLIVEIRA;20453;21534;41987;0,487126968;0,512873032
314660;PAIVA;739;778;1517;0,487145682;0,512854318
280370;MACAMBIRA;3411;3591;7002;0,48714653;0,51285347
260530;EXU;15447;16262;31709;0,487148759;0,512851241
432350;VISTA ALEGRE;1328;1398;2726;0,487160675;0,512839325
270410;LAGOA DA CANOA;8619;9073;17692;0,487169342;0,512830658
355370;TAQUARITINGA;28036;29511;57547;0,487184388;0,512815612
231330;TAUA;28871;30388;59259;0,487200257;0,512799743
410960;GUARATUBA;18502;19472;37974;0,487228103;0,512771897
280680;SAO DOMINGOS;5494;5782;11276;0,487229514;0,512770486
311120;CAMPO BELO;26476;27862;54338;0,487246494;0,512753506
270390;JUNDIA;2007;2112;4119;0,487254188;0,512745812
500380;FATIMA DO SUL;9332;9820;19152;0,487259816;0,512740184
251420;SAO JOSE DA LAGOA TAPADA;3714;3908;7622;0,487273681;0,512726319
230590;IPUEIRAS;18549;19515;38064;0,487310845;0,512689155
412135;RANCHO ALEGRE D'OESTE;1268;1334;2602;0,487317448;0,512682552
210320;CHAPADINHA;39329;41376;80705;0,48731801;0,51268199
432320;VICTOR GRAEFF;1384;1456;2840;0,487323944;0,512676056
352590;JUNDIAI;208057;218878;426935;0,487327111;0,512672889
430040;ALEGRETE;35329;37164;72493;0,487343606;0,512656394
352410;ITUVERAVA;20595;21664;42259;0,487351807;0,512648193
430258;BOZANO;1023;1076;2099;0,48737494;0,51262506
260420;CATENDE;21337;22441;43778;0,487390927;0,512609073
210040;ALTAMIRA DO MARANHAO;4021;4229;8250;0,487393939;0,512606061
316770;SOBRALIA;2669;2807;5476;0,487399562;0,512600438
315570;RIO PIRACICABA;6982;7343;14325;0,487399651;0,512600349
500375;ELDORADO;6067;6380;12447;0,487426689;0,512573311
280570;PROPRIA;14504;15252;29756;0,487431106;0,512568894
120040;RIO BRANCO;204455;214997;419452;0,487433604;0,512566396
355500;TUPA;31984;33631;65615;0,487449516;0,512550484
430640;DOIS IRMAOS;16353;17194;33547;0,487465347;0,512534653
430163;BALNEARIO PINHAL;7139;7506;14645;0,487470126;0,512529874
330260;MANGARATIBA;22395;23546;45941;0,487473063;0,512526937
320080;BAIXO GUANDU;15240;16023;31263;0,487477209;0,512522791
354260;REGISTRO;27525;28938;56463;0,487487381;0,512512619
330220;ITAPERUNA;50872;53482;104354;0,48749449;0,51250551
311000;CAETE;22116;23248;45364;0,487523146;0,512476854
354200;QUINTANA;3284;3452;6736;0,487529691;0,512470309
250100;ARARUNA;10048;10562;20610;0,487530325;0,512469675
412310;SANTA AMELIA;1564;1644;3208;0,487531172;0,512468828
316090;SAO BRAS DO SUACUI;1838;1932;3770;0,487533156;0,512466844
280400;MARUIM;8448;8880;17328;0,487534626;0,512465374
280067;BOQUIM;13154;13826;26980;0,487546331;0,512453669
260220;BOM JARDIM;19521;20517;40038;0,487561816;0,512438184
270830;SAO JOSE DA LAJE;11733;12331;24064;0,487574801;0,512425199
355040;SAO PEDRO;17699;18599;36298;0,487602623;0,512397377
291890;LAJEDAO;1947;2046;3993;0,487603306;0,512396694
310880;BRAUNAS;2310;2427;4737;0,487650412;0,512349588
280450;NOSSA SENHORA DA GLORIA;18392;19323;37715;0,487657431;0,512342569
221150;VERA MENDES;1503;1579;3082;0,487670344;0,512329656
412670;TAMBOARA;2534;2662;5196;0,487682833;0,512317167
355010;SAO MANUEL;20135;21152;41287;0,487683775;0,512316225
240890;PARELHAS;10540;11071;21611;0,48771459;0,51228541
317047;URUANA DE MINAS;1588;1668;3256;0,487714988;0,512285012
291640;ITAPETINGA;37754;39654;77408;0,487727367;0,512272633
431780;SANTO AUGUSTO;6737;7076;13813;0,487728951;0,512271049
250300;CAAPORA;10769;11310;22079;0,487748539;0,512251461
240590;JOAO DIAS;1294;1359;2653;0,487749717;0,512250283
330025;ARRAIAL DO CABO;15036;15791;30827;0,487754241;0,512245759
353530;PALMITAL;10888;11434;22322;0,487769913;0,512230087
250830;LAGOA SECA;13525;14203;27728;0,487774091;0,512225909
350960;CAMPO LIMPO PAULISTA;42148;44259;86407;0,487784554;0,512215446
270070;BATALHA;8995;9445;18440;0,487798265;0,512201735
290780;CICERO DANTAS;15920;16716;32636;0,487804878;0,512195122
411210;JANDAIA DO SUL;10381;10900;21281;0,487806024;0,512193976
412140;REALEZA;8281;8695;16976;0,487806315;0,512193685
260240;BREJAO;4381;4600;8981;0,487807594;0,512192406
431900;SAO MARCOS;10613;11143;21756;0,487819452;0,512180548
410655;CORUMBATAI DO SUL;1482;1556;3038;0,487820935;0,512179065
311330;CARANGOLA;16109;16913;33022;0,487826298;0,512173702
431395;PANTANO GRANDE;4388;4607;8995;0,48782657;0,51217343
310250;AMPARO DO SERRA;2265;2378;4643;0,487831144;0,512168856
290170;ANTONIO CARDOSO;5693;5977;11670;0,487832048;0,512167952
260610;GLORIA DO GOITA;15049;15798;30847;0,487859435;0,512140565
251040;OLHO D'AGUA;3122;3277;6399;0,487888733;0,512111267
291290;IBIRATAIA;7063;7413;14476;0,487911025;0,512088975
230280;CANINDE;37806;39678;77484;0,487920087;0,512079913
411180;JACAREZINHO;19160;20108;39268;0,487929103;0,512070897
292100;MATA DE SAO JOAO;23247;24396;47643;0,487941565;0,512058435
351340;CRUZEIRO;40448;42447;82895;0,487942578;0,512057422
431530;QUARAI;10994;11537;22531;0,487949936;0,512050064
410400;CAMPINA GRANDE DO SUL;21505;22567;44072;0,487951534;0,512048466
411330;LARANJEIRAS DO SUL;15696;16471;32167;0,487953493;0,512046507
420390;CAPINZAL;11330;11888;23218;0,487983461;0,512016539
411670;NOVA AURORA;4944;5187;10131;0,488007107;0,511992893
430755;ESTACAO;2891;3033;5924;0,488014855;0,511985145
330300;MIRACEMA;13242;13892;27134;0,488022407;0,511977593
411720;NOVA OLIMPIA;2853;2993;5846;0,488026001;0,511973999
410530;CEU AZUL;5794;6078;11872;0,488039084;0,511960916
220830;PIRACURUCA;14130;14822;28952;0,488049185;0,511950815
270400;JUNQUEIRO;12063;12653;24716;0,488064412;0,511935588
230930;NOVA RUSSAS;15856;16631;32487;0,488072152;0,511927848
431360;PAIM FILHO;1821;1910;3731;0,488072903;0,511927097
251550;SERRA BRANCA;6739;7068;13807;0,488085754;0,511914246
220040;ALTOS;19856;20825;40681;0,488090263;0,511909737
431320;NOVA PETROPOLIS;10600;11117;21717;0,488096883;0,511903117
420800;ITA;2973;3118;6091;0,488097193;0,511902807
241450;UMARIZAL;5118;5367;10485;0,488125894;0,511874106
312230;DIVINOPOLIS;118373;124132;242505;0,488126018;0,511873982
230710;JARDIM;13271;13916;27187;0,488137713;0,511862287
292380;PARIPIRANGA;14217;14907;29124;0,4881541;0,5118459
240400;FRUTUOSO GOMES;1960;2055;4015;0,488169365;0,511830635
260970;OROBO;11709;12276;23985;0,488180113;0,511819887
520110;ANAPOLIS;193577;202949;396526;0,488182364;0,511817636
241210;SAO JOAO DO SABUGI;3037;3184;6221;0,488185179;0,511814821
351000;CANDIDO MOTA;15334;16076;31410;0,488188475;0,511811525
312090;CURVELO;39586;41499;81085;0,488203737;0,511796263
260210;BOM CONSELHO;23910;25065;48975;0,48820827;0,51179173
270470;MARECHAL DEODORO;25801;27047;52848;0,488211474;0,511788526
260550;FERREIROS;5964;6252;12216;0,488212181;0,511787819
412555;SAO MANOEL DO PARANA;1057;1108;2165;0,488221709;0,511778291
520355;BONFINOPOLIS;4941;5179;10120;0,488241107;0,511758893
411690;NOVA ESPERANCA;13702;14360;28062;0,48827596;0,51172404
314800;PATOS DE MINAS;75509;79132;154641;0,488285772;0,511714228
510340;CUIABA;304515;319099;623614;0,488306869;0,511693131
220910;SANTA CRUZ DO PIAUI;3054;3200;6254;0,48832747;0,51167253
330420;RESENDE;65067;68177;133244;0,488329681;0,511670319
314020;MARIPA DE MINAS;1465;1535;3000;0,488333333;0,511666667
292770;SANTA CRUZ CABRALIA;13702;14356;28058;0,48834557;0,51165443
261110;PETROLINA;175498;183874;359372;0,488346337;0,511653663
211290;VITORIA DO MEARIM;16094;16862;32956;0,4883481;0,5116519
430390;CAMPO BOM;34176;35805;69981;0,488361127;0,511638873
270255;ESTRELA DE ALAGOAS;8939;9365;18304;0,488363199;0,511636801
250110;AREIA;10985;11508;22493;0,488374161;0,511625839
311535;CATAS ALTAS;2669;2796;5465;0,488380604;0,511619396
320420;PIUMA;10934;11454;22388;0,488386636;0,511613364
431306;NOVA HARTZ;10817;11330;22147;0,488418296;0,511581704
350970;CAMPOS DO JORDAO;25746;26967;52713;0,488418417;0,511581583
260860;LAGOA DO OURO;6496;6804;13300;0,488421053;0,511578947
293270;URUCUCA;9921;10391;20312;0,488430484;0,511569516
280510;PEDRINHAS;4751;4976;9727;0,488434255;0,511565745
220470;INHUMA;7488;7842;15330;0,488454012;0,511545988
221120;URUCUI;10622;11124;21746;0,488457647;0,511542353
421227;PASSOS MAIA;1989;2083;4072;0,48845776;0,51154224
350150;ALVINLANDIA;1588;1663;3251;0,488465088;0,511534912
354330;RIBEIRAO PIRES;61177;64061;125238;0,488485923;0,511514077
250939;MATUREIA;3268;3422;6690;0,488490284;0,511509716
241120;SANTA CRUZ;19684;20611;40295;0,488497332;0,511502668
310160;ALFENAS;39556;41417;80973;0,488508515;0,511491485
251530;SAPE;25880;27097;52977;0,488513883;0,511486117
315360;PRUDENTE DE MORAIS;5340;5591;10931;0,488518891;0,511481109
270880;SAO SEBASTIAO;16817;17607;34424;0,488525447;0,511474553
270130;CAJUEIRO;10453;10944;21397;0,488526429;0,511473571
421770;SOMBRIO;15186;15898;31084;0,488547163;0,511452837
250730;JACARAU;7068;7399;14467;0,488560171;0,511439829
354390;RIO CLARO;102377;107171;209548;0,488561093;0,511438907
292710;RODELAS;4665;4883;9548;0,488583997;0,511416003
220277;COLONIA DO PIAUI;3745;3920;7665;0,488584475;0,511415525
410150;ARAPONGAS;61828;64717;126545;0,488585088;0,511414912
220480;IPIRANGA DO PIAUI;4819;5044;9863;0,488593734;0,511406266
260150;BELEM DE MARIA;5946;6223;12169;0,488618621;0,511381379
330400;PIRAI;14562;15240;29802;0,488624925;0,511375075
261590;TUPARETAMA;4039;4227;8266;0,488628115;0,511371885
330185;GUAPIMIRIM;30406;31819;62225;0,488646043;0,511353957
410120;ANTONINA;9245;9674;18919;0,488662191;0,511337809
432220;TUPANCIRETA;11817;12365;24182;0,488669258;0,511330742
520780;FIRMINOPOLIS;6648;6956;13604;0,4886798;0,5113202
430590;CORONEL BICACO;3525;3688;7213;0,488700957;0,511299043
210360;COROATA;32151;33637;65788;0,488706147;0,511293853
230830;MILAGRES;13397;14016;27413;0,488709736;0,511290264
430940;GUAPORE;12804;13395;26199;0,488720944;0,511279056
280720;SIRIRI;4421;4625;9046;0,488724298;0,511275702
261320;SAO JOAO;11242;11760;23002;0,48874011;0,51125989
352480;JALES;24091;25200;49291;0,488750482;0,511249518
431442;PICADA CAFE;2825;2955;5780;0,488754325;0,511245675
261630;VICENCIA;16079;16818;32897;0,488767973;0,511232027
521340;MOIPORA;719;752;1471;0,488783141;0,511216859
314930;PEDRO LEOPOLDO;31845;33304;65149;0,488802591;0,511197409
431570;RIO PARDO;18701;19556;38257;0,488825574;0,511174426
521450;NEROPOLIS;15120;15811;30931;0,488829976;0,511170024
240940;PAU DOS FERROS;15057;15745;30802;0,488831894;0,511168106
230960;PACAJUS;36245;37900;74145;0,488839436;0,511160564
250890;MAMANGUAPE;22186;23199;45385;0,488839925;0,511160075
250740;JERICO;3789;3962;7751;0,48884015;0,51115985
431990;SAPIRANGA;39360;41154;80514;0,48885908;0,51114092
316320;SAO JOSE DO ALEGRE;2064;2158;4222;0,488867835;0,511132165
316100;SAO DOMINGOS DO PRATA;8456;8840;17296;0,488899167;0,511100833
251110;PEDRA LAVRADA;3889;4065;7954;0,488936384;0,511063616
411340;LEOPOLIS;1905;1991;3896;0,488963039;0,511036961
510395;GLORIA D'OESTE;1462;1528;2990;0,488963211;0,511036789
251400;SAO JOAO DO CARIRI;2039;2131;4170;0,488968825;0,511031175
432110;TAPES;8490;8873;17363;0,4889708;0,5110292
412110;QUINTA DO SOL;2173;2271;4444;0,488973897;0,511026103
350240;ANHUMAS;2040;2132;4172;0,488974113;0,511025887
431164;LINHA NOVA;843;881;1724;0,488979118;0,511020882
240780;MONTE ALEGRE;11099;11599;22698;0,488985814;0,511014186
260805;JATOBA;7288;7616;14904;0,488996243;0,511003757
431405;PAROBE;29056;30363;59419;0,489001834;0,510998166
330430;RIO BONITO;29795;31135;60930;0,489003775;0,510996225
280190;CUMBE;1960;2048;4008;0,489021956;0,510978044
410790;FLORESTA;3387;3539;6926;0,489026855;0,510973145
290630;CANAVIEIRAS;15024;15698;30722;0,489030662;0,510969338
431800;SAO BORJA;29229;30539;59768;0,489040958;0,510959042
292990;SEABRA;21699;22671;44370;0,489046653;0,510953347
292895;SAO DOMINGOS;4443;4642;9085;0,489047881;0,510952119
350410;ATIBAIA;71099;74279;145378;0,489062994;0,510937006
431370;PALMEIRA DAS MISSOES;16123;16844;32967;0,489064822;0,510935178
520549;CIDADE OCIDENTAL;36372;37998;74370;0,489068173;0,510931827
240920;PASSAGEM;1523;1591;3114;0,489081567;0,510918433
350635;BERTIOGA;32355;33799;66154;0,489086072;0,510913928
211300;VITORINO FREIRE;15416;16104;31520;0,489086294;0,510913706
314010;MARILAC;1995;2084;4079;0,489090463;0,510909537
521950;SANTA ROSA DE GOIAS;1076;1124;2200;0,489090909;0,510909091
354620;SANTA CRUZ DA CONCEICAO;2242;2342;4584;0,489092496;0,510907504
351518;ESPIRITO SANTO DO PINHAL;21817;22790;44607;0,48909364;0,51090636
110011;JARU;25174;26295;51469;0,48910995;0,51089005
521080;ITAJA;2158;2254;4412;0,48912058;0,51087942
351550;FERNANDOPOLIS;34082;35598;69680;0,489121699;0,510878301
410185;ARIRANHA DO IVAI;991;1035;2026;0,489141165;0,510858835
280730;TELHA;1600;1671;3271;0,48914705;0,51085295
430420;CANDELARIA;15396;16079;31475;0,489150119;0,510849881
330210;ITAOCARA;11354;11857;23211;0,48916462;0,51083538
290570;CAMACARI;151255;157953;309208;0,489169103;0,510830897
317020;UBERLANDIA;345649;360948;706597;0,489174169;0,510825831
316290;SAO JOAO NEPOMUCENO;12978;13552;26530;0,489182058;0,510817942
316360;SAO JOSE DO MANTIMENTO;1380;1441;2821;0,489188231;0,510811769
351300;COTIA;126163;131719;257882;0,489227631;0,510772369
353870;PIRACICABA;200718;209557;410275;0,489227957;0,510772043
431090;JACUTINGA;1728;1804;3532;0,489241223;0,510758777
330205;ITALVA;7528;7859;15387;0,489244167;0,510755833
290320;BARREIRAS;77512;80920;158432;0,489244597;0,510755403
293135;TEIXEIRA DE FREITAS;80378;83912;164290;0,489244628;0,510755372
412490;SAO JOAO DO CAIUA;2847;2972;5819;0,489259323;0,510740677
410940;GUARAPUAVA;89904;93851;183755;0,489260156;0,510739844
292050;MARACAS;9772;10201;19973;0,489260502;0,510739498
220350;ELESBAO VELOSO;7119;7431;14550;0,489278351;0,510721649
280590;RIACHUELO;5066;5288;10354;0,489279506;0,510720494
290520;CAETITE;25044;26140;51184;0,489293529;0,510706471
411845;PATO BRAGADO;2816;2939;5755;0,48931364;0,51068636
210770;PARAIBANO;10555;11016;21571;0,489314357;0,510685643
210632;MARACACUME;10654;11119;21773;0,489321637;0,510678363
250215;BOA VISTA;3532;3686;7218;0,489332225;0,510667775
354000;POMPEIA;10925;11401;22326;0,489339783;0,510660217
261000;PALMARES;31195;32550;63745;0,489371715;0,510628285
411420;MANDAGUARI;16946;17682;34628;0,489372762;0,510627238
270590;OLHO D'AGUA GRANDE;2512;2621;5133;0,489382427;0,510617573
270170;CAPELA;8274;8633;16907;0,489383096;0,510616904
240320;DOUTOR SEVERIANO;3459;3609;7068;0,489388795;0,510611205
292240;MUTUIPE;10933;11407;22340;0,489391226;0,510608774
230860;MONSENHOR TABOSA;8449;8815;17264;0,489399907;0,510600093
412800;UBIRATA;10184;10625;20809;0,489403623;0,510596377
420230;BIGUACU;34489;35982;70471;0,48940699;0,51059301
260230;BONITO;18647;19454;38101;0,489409727;0,510590273
412640;SERTANEJA;2520;2629;5149;0,48941542;0,51058458
290840;CONCEICAO DO COITE;32984;34410;67394;0,489420423;0,510579577
280660;SANTO AMARO DAS BROTAS;5971;6229;12200;0,48942623;0,51057377
291670;ITAQUARA;4099;4276;8375;0,489432836;0,510567164
270220;COQUEIRO SECO;2879;3003;5882;0,489459368;0,510540632
431830;SAO GABRIEL;30440;31747;62187;0,489491373;0,510508627
241430;TIMBAUBA DOS BATISTAS;1188;1239;2427;0,489493201;0,510506799
355710;VOTUPORANGA;47044;49062;96106;0,489501176;0,510498824
431535;QUINZE DE NOVEMBRO;1865;1945;3810;0,489501312;0,510498688
250020;AGUIAR;2752;2870;5622;0,489505514;0,510494486
170210;ARAGUAINA;91169;95076;186245;0,489511128;0,510488872
430210;BENTO GONCALVES;60254;62836;123090;0,489511739;0,510488261
250490;CRUZ DO ESPIRITO SANTO;8615;8984;17599;0,48951645;0,51048355
430530;CHAPADA;4509;4702;9211;0,489523396;0,510476604
210790;PASSAGEM FRANCA;9425;9828;19253;0,489534099;0,510465901
411400;MAMBORE;6315;6585;12900;0,489534884;0,510465116
410220;ATALAIA;1895;1976;3871;0,489537587;0,510462413
293050;SERRINHA;39992;41701;81693;0,489540107;0,510459893
355250;SUZANO;148528;154869;303397;0,489549996;0,510450004
430240;BOM RETIRO DO SUL;6094;6354;12448;0,489556555;0,510443445
170255;AUGUSTINOPOLIS;9238;9632;18870;0,489560148;0,510439852
430960;HORIZONTINA;9520;9926;19446;0,489560835;0,510439165
313510;JANAUBA;35432;36942;72374;0,489568077;0,510431923
270610;OURO BRANCO;5666;5907;11573;0,489587834;0,510412166
431775;SANTO ANTONIO DO PLANALTO;988;1030;2018;0,489593657;0,510406343
261180;RIBEIRAO;23409;24404;47813;0,48959488;0,51040512
352310;ITAQUAQUECETUBA;185597;193485;379082;0,489595919;0,510404081
310240;ALVORADA DE MINAS;1765;1840;3605;0,489597781;0,510402219
291370;INHAMBUPE;19937;20783;40720;0,489611984;0,510388016
150220;CAPANEMA;34189;35639;69828;0,489617345;0,510382655
292190;MUCUGE;4272;4453;8725;0,489627507;0,510372493
230425;CRUZ;12300;12821;25121;0,48963019;0,51036981
350050;AGUAS DE LINDOIA;9258;9650;18908;0,489634017;0,510365983
230680;JAGUARIBARA;5670;5910;11580;0,489637306;0,510362694
412570;SAO MIGUEL DO IGUACU;13561;14135;27696;0,489637493;0,510362507
110004;CACOAL;42314;44102;86416;0,489654694;0,510345306
311340;CARATINGA;45600;47524;93124;0,489669688;0,510330312
355060;SAO ROQUE;45578;47498;93076;0,489685848;0,510314152
411710;NOVA LONDRINA;6458;6730;13188;0,489687595;0,510312405
432270;VERA CRUZ;13381;13944;27325;0,489698079;0,510301921
353430;ORLANDIA;21881;22801;44682;0,489705027;0,510294973
221060;SAO RAIMUNDO NONATO;17157;17878;35035;0,48971029;0,51028971
315610;RITAPOLIS;2214;2307;4521;0,489714665;0,510285335
315420;RESENDE COSTA;5670;5908;11578;0,489721886;0,510278114
352530;JAU;75155;78308;153463;0,489727166;0,510272834
354990;SAO JOSE DOS CAMPOS;361086;376224;737310;0,489734304;0,510265696
220027;ALEGRETE DO PIAUI;2410;2511;4921;0,489737858;0,510262142
412070;QUATIGUA;3675;3829;7504;0,489738806;0,510261194
353800;PINDAMONHANGABA;84187;87698;171885;0,489786776;0,510213224
431640;ROSARIO DO SUL;19205;20005;39210;0,489798521;0,510201479
350650;BIRIGUI;61761;64333;126094;0,489801259;0,510198741
314750;PASSABEM;793;826;1619;0,489808524;0,510191476
171889;SANTA RITA DO TOCANTINS;1179;1228;2407;0,489821354;0,510178646
261250;SANTA CRUZ DO CAPIBARIBE;54770;57042;111812;0,489840089;0,510159911
231360;UBAJARA;17289;18006;35295;0,489842754;0,510157246
313320;ITANHOMI;6005;6254;12259;0,489844196;0,510155804
251490;SAO MAMEDE;3763;3919;7682;0,489846394;0,510153606
270260;FEIRA GRANDE;10871;11321;22192;0,489861211;0,510138789
240650;LAGOA NOVA;7779;8101;15880;0,489861461;0,510138539
521960;SANTA TEREZA DE GOIAS;1571;1636;3207;0,489865918;0,510134082
251597;SOBRADO;3843;4002;7845;0,489866157;0,510133843
353410;ORIENTE;3218;3351;6569;0,489876694;0,510123306
220600;MARCOS PARENTE;2227;2319;4546;0,489881214;0,510118786
170370;BREJINHO DE NAZARE;2714;2826;5540;0,489891697;0,510108303
241415;TENENTE LAURENTINO CRUZ;2981;3104;6085;0,48989318;0,51010682
330120;CARMO;9387;9774;19161;0,489901362;0,510098638
320120;CACHOEIRO DE ITAPEMIRIM;103947;108225;212172;0,489918557;0,510081443
411295;JURANDA;3549;3695;7244;0,489922695;0,510077305
270840;SAO JOSE DA TAPERA;15904;16558;32462;0,489926684;0,510073316
270530;MINADOR DO NEGRAO;2604;2711;5315;0,489934149;0,510065851
211400;ZE DOCA;25570;26620;52190;0,489940602;0,510059398
290790;CIPO;8526;8876;17402;0,489943685;0,510056315
500450;ITAPORA;12483;12995;25478;0,489952116;0,510047884
351450;DUARTINA;6086;6335;12421;0,489976652;0,510023348
420140;ARARANGUA;34050;35443;69493;0,489977408;0,510022592
430500;CATUIPE;4229;4402;8631;0,489977986;0,510022014
251445;SAO JOSE DOS RAMOS;2958;3079;6037;0,489978466;0,510021534
310285;ANGELANDIA;4211;4383;8594;0,489993018;0,510006982
240720;MACAU;15808;16452;32260;0,490018599;0,509981401
350335;ARCO-IRIS;860;895;1755;0,49002849;0,50997151
280710;SIMAO DIAS;19956;20768;40724;0,490030449;0,509969551
240520;JANDUIS;2562;2666;5228;0,490053558;0,509946442
260350;CAMOCIM DE SAO FELIX;9327;9705;19032;0,490069357;0,509930643
430760;ESTANCIA VELHA;25137;26155;51292;0,490076425;0,509923575
240260;CEARA-MIRIM;36397;37871;74268;0,49007648;0,50992352
270150;CAMPO GRANDE;4693;4883;9576;0,490079365;0,509920635
280020;AQUIDABA;10682;11114;21796;0,490089925;0,509910075
261650;XEXEU;7248;7541;14789;0,490093989;0,509906011
430270;BUTIA;10274;10689;20963;0,490101608;0,509898392
412550;SAO JOSE DOS PINHAIS;164000;170620;334620;0,490108182;0,509891818
353130;MONTE ALTO;25015;26024;51039;0,490115402;0,509884598
315410;RECREIO;5157;5365;10522;0,490115948;0,509884052
310670;BETIM;220567;229457;450024;0,490122749;0,509877251
293040;SERRA PRETA;7122;7409;14531;0,490124561;0,509875439
430740;ESMERALDA;1613;1678;3291;0,490124582;0,509875418
353080;MOGI MIRIM;46121;47977;94098;0,490137941;0,509862059
240020;ACU;28793;29950;58743;0,490152018;0,509847982
412530;SAO JORGE DO IVAI;2713;2822;5535;0,490153568;0,509846432
520490;CAMPOS BELOS;9864;10260;20124;0,490161002;0,509838998
432280;VERANOPOLIS;13143;13670;26813;0,490172677;0,509827323
316400;SAO PEDRO DOS FERROS;3742;3892;7634;0,490175531;0,509824469
270700;PINDOBA;1423;1480;2903;0,49018257;0,50981743
292410;PEDRAO;3646;3792;7438;0,490185534;0,509814466
430490;CASCA;4446;4624;9070;0,490187431;0,509812569
355660;VERA CRUZ;5296;5508;10804;0,490188819;0,509811181
260260;BREJO DA MADRE DE DEUS;25341;26355;51696;0,490192665;0,509807335
500090;ANTONIO JOAO;4452;4630;9082;0,490200396;0,509799604
231280;SENADOR SA;3803;3955;7758;0,490203661;0,509796339
270660;PAULO JACINTO;3704;3852;7556;0,490206458;0,509793542
411480;MARIALVA;17698;18405;36103;0,49020857;0,50979143
510125;ARAPUTANGA;8372;8706;17078;0,490221337;0,509778663
412270;SABAUDIA;3409;3545;6954;0,490221455;0,509778545
350630;BERNARDINO DE CAMPOS;5475;5693;11168;0,490239971;0,509760029
260900;MACAPARANA;12533;13032;25565;0,490240563;0,509759437
312320;DORES DO INDAIA;6556;6817;13373;0,490241531;0,509758469
313760;LAGOA SANTA;32721;34023;66744;0,490246314;0,509753686
170825;FORTALEZA DO TABOCAO;1282;1333;2615;0,490248566;0,509751434
431720;SANTA ROSA;36221;37661;73882;0,490254731;0,509745269
412820;UNIAO DA VITORIA;28581;29717;58298;0,490256956;0,509743044
250860;LUCENA;6542;6802;13344;0,490257794;0,509742206
354890;SAO CARLOS;125956;130959;256915;0,490263317;0,509736683
260450;CHA GRANDE;10751;11178;21929;0,490264034;0,509735966
354690;SANTA LUCIA;4358;4531;8889;0,490268872;0,509731128
353940;PIRATININGA;6810;7080;13890;0,490280778;0,509719222
250933;MATINHAS;2220;2308;4528;0,490282686;0,509717314
520929;GUARAITA;934;971;1905;0,490288714;0,509711286
520450;CALDAS NOVAS;46670;48513;95183;0,490318649;0,509681351
410570;CLEVELANDIA;8014;8330;16344;0,490332844;0,509667156
430130;ARROIO GRANDE;8917;9268;18185;0,490349189;0,509650811
251275;RIACHAO DO BACAMARTE;2237;2325;4562;0,490355107;0,509644893
354210;RAFARD;4475;4651;9126;0,490357221;0,509642779
210125;BACABEIRA;8555;8891;17446;0,490370285;0,509629715
250280;BREJO DO CRUZ;7006;7281;14287;0,490375866;0,509624134
292660;RIBEIRA DO POMBAL;26529;27568;54097;0,49039688;0,50960312
432345;VILA NOVA DO SUL;2096;2178;4274;0,490407113;0,509592887
521120;ITAPURANGA;12553;13044;25597;0,490409032;0,509590968
230260;CAMOCIM;31459;32688;64147;0,490420441;0,509579559
521925;SANTA FE DE GOIAS;2739;2846;5585;0,49042077;0,50957923
431120;JULIO DE CASTILHOS;9396;9763;19159;0,490422256;0,509577744
261360;SAO JOSE DO EGITO;16778;17432;34210;0,490441391;0,509558609
280310;ITABI;2388;2481;4869;0,490449784;0,509550216
315020;PIEDADE DE PONTE NOVA;2031;2110;4141;0,490461241;0,509538759
412720;TERRA BOA;8487;8817;17304;0,490464632;0,509535368
330270;MARICA;82238;85430;167668;0,490481189;0,509518811
310550;BARAO DE MONTE ALTO;2605;2706;5311;0,490491433;0,509508567
520140;APARECIDA DE GOIANIA;295202;306642;601844;0,490495876;0,509504124
270870;SAO MIGUEL DOS MILAGRES;3960;4113;8073;0,490523969;0,509476031
411440;MANGUEIRINHA;8129;8443;16572;0,490526189;0,509473811
320332;MARATAIZES;19258;20001;39259;0,490537202;0,509462798
354640;SANTA CRUZ DO RIO PARDO;23648;24559;48207;0,490551165;0,509448835
220440;GILBUES;5248;5450;10698;0,490558983;0,509441017
220595;MARCOLANDIA;4214;4376;8590;0,490570431;0,509429569
410580;COLOMBO;122290;126987;249277;0,490578754;0,509421246
412340;SANTA FE;6049;6281;12330;0,490592052;0,509407948
500220;BONITO;10990;11411;22401;0,490603098;0,509396902
410300;BOA ESPERANCA;1958;2033;3991;0,490603859;0,509396141
522010;SAO LUIS DE MONTES BELOS;16920;17568;34488;0,490605428;0,509394572
500370;DOURADOS;111856;116134;227990;0,49061801;0,50938199
250205;BERNARDINO BATISTA;1752;1819;3571;0,490618874;0,509381126
250510;CUITE;9975;10356;20331;0,490630072;0,509369928
313980;MAR DE ESPANHA;6371;6614;12985;0,49064305;0,50935695
353110;MONGAGUA;28736;29831;58567;0,490651732;0,509348268
250650;GURJAO;1706;1771;3477;0,490652862;0,509347138
355220;SOROCABA;341166;354162;695328;0,49065477;0,50934523
250910;MARI;10743;11152;21895;0,490659968;0,509340032
210440;GONCALVES DIAS;8809;9144;17953;0,490670083;0,509329917
260300;CABROBO;17065;17713;34778;0,490683766;0,509316234
500630;PARANAIBA;20806;21595;42401;0,490695974;0,509304026
522140;TRINDADE;64775;67231;132006;0,490697393;0,509302607
354960;SAO JOSE DO BARREIRO;2032;2109;4141;0,490702729;0,509297271
430045;ALEGRIA;1613;1674;3287;0,490721022;0,509278978
311570;CENTRAL DE MINAS;3464;3595;7059;0,490721065;0,509278935
353930;PIRASSUNUNGA;37948;39382;77330;0,490728049;0,509271951
312520;FAMA;1165;1209;2374;0,49073294;0,50926706
410200;ASSIS CHATEAUBRIAND;16345;16961;33306;0,490752417;0,509247583
410775;FIGUEIRA;3742;3883;7625;0,490754098;0,509245902
412625;SARANDI;48532;50356;98888;0,490777445;0,509222555
521975;SANTO ANTONIO DO DESCOBERTO;37727;39144;76871;0,49078326;0,50921674
220180;BOCAINA;2213;2296;4509;0,490796185;0,509203815
231180;RUSSAS;39043;40507;79550;0,49079824;0,50920176
412860;VERE;3482;3612;7094;0,490837327;0,509162673
220635;MILTON BRANDAO;3241;3362;6603;0,490837498;0,509162502
432163;TRES ARROIOS;1286;1334;2620;0,490839695;0,509160305
431450;PINHEIRO MACHADO;5950;6172;12122;0,490843095;0,509156905
220915;SANTA CRUZ DOS MILAGRES;1986;2060;4046;0,490855166;0,509144834
211060;SAO BERNARDO;14149;14676;28825;0,49085863;0,50914137
353160;MONTE CASTELO;2045;2121;4166;0,490878541;0,509121459
293300;VALENTE;14290;14821;29111;0,490879736;0,509120264
250523;CUITE DE MAMANGUAPE;3122;3238;6360;0,490880503;0,509119497
352690;LIMEIRA;152565;158218;310783;0,49090523;0,50909477
352940;MAUA;236486;245239;481725;0,490914941;0,509085059
220680;NOSSA SENHORA DOS REMEDIOS;4296;4455;8751;0,490915324;0,509084676
412010;PORTO AMAZONAS;2405;2494;4899;0,490916514;0,509083486
420240;BLUMENAU;179881;186537;366418;0,490917477;0,509082523
280460;NOSSA SENHORA DAS DORES;13234;13723;26957;0,49093;0,50907
355090;SAO SIMAO;7583;7863;15446;0,490936165;0,509063835
290900;CORDEIROS;4255;4412;8667;0,490942656;0,509057344
291690;ITIRUCU;6128;6354;12482;0,490946964;0,509053036
292530;PORTO SEGURO;74885;77644;152529;0,490955818;0,509044182
350160;AMERICANA;119976;124394;244370;0,490960429;0,509039571
521523;NOVO GAMA;58744;60905;119649;0,490969419;0,509030581
221160;VILA NOVA DO PIAUI;1441;1494;2935;0,490971039;0,509028961
500410;GUIA LOPES DA LAGUNA;4789;4965;9754;0,49097806;0,50902194
350580;BASTOS;10287;10665;20952;0,490979381;0,509020619
260990;OURICURI;34598;35868;70466;0,490988562;0,509011438
250403;CAPIM;3297;3418;6715;0,49099032;0,50900968
220370;ESPERANTINA;19617;20336;39953;0,491001927;0,508998073
354940;SAO JOAQUIM DA BARRA;25894;26843;52737;0,491002522;0,508997478
410765;FAZENDA RIO GRANDE;50943;52807;103750;0,491016867;0,508983133
411300;JUSSARA;3471;3598;7069;0,491017117;0,508982883
291420;IRAJUBA;3582;3713;7295;0,491021247;0,508978753
350860;CACHOEIRA PAULISTA;16610;17217;33827;0,491027877;0,508972123
230426;DEPUTADO IRAPUAN PINHEIRO;4762;4936;9698;0,491029078;0,508970922
270340;JACARE DOS HOMENS;2546;2639;5185;0,491031823;0,508968177
110012;JI-PARANA;64338;66688;131026;0,491032314;0,508967686
220670;NAZARE DO PIAUI;3588;3719;7307;0,491035993;0,508964007
220937;SANTA ROSA DO PIAUI;2580;2674;5254;0,491054435;0,508945565
521590;PALMINOPOLIS;1757;1821;3578;0,491056456;0,508943544
351610;FLORINIA;1292;1339;2631;0,491068035;0,508931965
291030;ELISIO MEDRADO;3992;4137;8129;0,491081314;0,508918686
320035;ALTO RIO NOVO;3885;4026;7911;0,491088358;0,508911642
313610;JOANESIA;2152;2230;4382;0,491099954;0,508900046
210230;BURITI BRAVO;11783;12210;23993;0,491101571;0,508898429
230430;FARIAS BRITO;9493;9837;19330;0,491101914;0,508898086
420920;LACERDOPOLIS;1104;1144;2248;0,491103203;0,508896797
410480;CASCAVEL;165053;171020;336073;0,491122464;0,508877536
260520;ESCADA;34232;35469;69701;0,491126383;0,508873617
316940;TRES PONTAS;28057;29070;57127;0,49113379;0,50886621
411200;JAGUARIAIVA;17284;17908;35192;0,491134349;0,508865651
261310;SAO CAITANO;18412;19076;37488;0,491143833;0,508856167
420940;LAGUNA;22801;23623;46424;0,491146821;0,508853179
250980;MULUNGU;4893;5069;9962;0,491166432;0,508833568
412382;SANTA LUCIA;1864;1931;3795;0,491172596;0,508827404
330520;SAO PEDRO DA ALDEIA;52830;54726;107556;0,491185987;0,508814013
291005;DIAS D'AVILA;41116;42589;83705;0,491201242;0,508798758
412870;VITORINO;3379;3500;6879;0,491205117;0,508794883
150680;SANTAREM;151458;156881;308339;0,491206108;0,508793892
411820;PARANAGUA;77307;80071;157378;0,491218595;0,508781405
251700;UMBUZEIRO;4870;5044;9914;0,491224531;0,508775469
411550;MARUMBI;2297;2379;4676;0,491231822;0,508768178
431770;SANTO ANTONIO DAS MISSOES;4878;5052;9930;0,491238671;0,508761329
314840;PAULISTAS;2355;2439;4794;0,491239049;0,508760951
261100;PETROLANDIA;18297;18949;37246;0,491247382;0,508752618
270330;INHAPI;9038;9360;18398;0,491249049;0,508750951
220945;SANTO ANTONIO DOS MILAGRES;1067;1105;2172;0,491252302;0,508747698
260490;CUMARU;4664;4830;9494;0,491257636;0,508742364
352710;LINS;38799;40179;78978;0,49126339;0,50873661
250700;ITAPORANGA;12262;12698;24960;0,491266026;0,508733974
251500;SAO MIGUEL DE TAIPU;3660;3790;7450;0,491275168;0,508724832
421850;TREZE TILIAS;3998;4140;8138;0,491275498;0,508724502
280120;CANINDE DE SAO FRANCISCO;15178;15716;30894;0,491292808;0,508707192
311250;CAPIM BRANCO;4862;5034;9896;0,49130962;0,50869038
231085;PINDORETAMA;10300;10664;20964;0,491318451;0,508681549
313920;MALACACHETA;9117;9439;18556;0,491323561;0,508676439
311787;CONFINS;3374;3493;6867;0,491335372;0,508664628
240300;CRUZETA;3915;4053;7968;0,491340361;0,508659639
432055;SERTAO SANTANA;3236;3350;6586;0,491345278;0,508654722
354730;SANTANA DE PARNAIBA;71282;73791;145073;0,491352629;0,508647371
290090;ALMADINA;2591;2682;5273;0,491371136;0,508628864
411580;MEDIANEIRA;23065;23875;46940;0,491371964;0,508628036
432020;SEBERI;5247;5431;10678;0,491384154;0,508615846
314190;MINDURI;1912;1979;3891;0,491390388;0,508609612
230990;PACUJA;3226;3339;6565;0,491393755;0,508606245
431610;RONDA ALTA;5225;5408;10633;0,491394715;0,508605285
261130;POMBOS;13368;13836;27204;0,491398324;0,508601676
430692;ENGENHO VELHO;458;474;932;0,491416309;0,508583691
172049;SAO VALERIO;1891;1957;3848;0,491424116;0,508575884
430790;FARROUPILHA;36247;37511;73758;0,491431438;0,508568562
293320;VERA CRUZ;21714;22471;44185;0,491433744;0,508566256
353620;PARIQUERA-ACU;9729;10068;19797;0,491438097;0,508561903
260840;JUREMA;7609;7874;15483;0,491442227;0,508557773
354220;RANCHARIA;14617;15126;29743;0,491443365;0,508556635
291165;GUAJERU;3131;3240;6371;0,491445613;0,508554387
410210;ASTORGA;12927;13377;26304;0,491446168;0,508553832
251290;RIO TINTO;11922;12336;24258;0,491466733;0,508533267
521150;ITUMBIARA;52511;54334;106845;0,49146895;0,50853105
410337;BRASILANDIA DO SUL;1239;1282;2521;0,491471638;0,508528362
231140;QUIXERAMOBIM;40525;41930;82455;0,491480201;0,508519799
250050;ALAGOINHA;7190;7439;14629;0,491489507;0,508510493
313380;ITAUNA;46424;48031;94455;0,491493304;0,508506696
261620;VERTENTES;10406;10766;21172;0,491498205;0,508501795
220340;DOM EXPEDITO LOPES;3411;3529;6940;0,491498559;0,508501441
411700;NOVA FATIMA;3991;4129;8120;0,491502463;0,508497537
430543;CHUI;3358;3474;6832;0,491510539;0,508489461
231230;SAO BENEDITO;23767;24587;48354;0,491520867;0,508479133
310180;ALPERCATA;3661;3787;7448;0,491541353;0,508458647
314490;NOVA MODICA;1744;1804;3548;0,491544532;0,508455468
230300;CARIDADE;11311;11700;23011;0,491547521;0,508452479
250390;CAMALAU;2973;3075;6048;0,49156746;0,50843254
210735;NOVA OLINDA DO MARANHAO;10435;10793;21228;0,491567741;0,508432259
510840;VARZEA GRANDE;142746;147637;290383;0,491578364;0,508421636
220650;MONSENHOR HIPOLITO;3827;3958;7785;0,491586384;0,508413616
210150;BARAO DE GRAJAU;9353;9673;19026;0,491590455;0,508409545
251120;PEDRAS DE FOGO;14063;14544;28607;0,491592967;0,508407033
250810;LAGOA;2281;2359;4640;0,491594828;0,508405172
314630;PADRE PARAISO;10002;10344;20346;0,4915954;0,5084046
521020;IPORA;15471;16000;31471;0,491595437;0,508404563
270235;CRAIBAS;11993;12403;24396;0,491596983;0,508403017
251150;PILAR;5917;6119;12036;0,491608508;0,508391492
261090;PESQUEIRA;33463;34604;68067;0,491618552;0,508381448
231300;SOLONOPOLE;9041;9348;18389;0,491652618;0,508347382
230835;MILHA;6455;6674;13129;0,491659685;0,508340315
421900;URUSSANGA;10531;10888;21419;0,491666278;0,508333722
330415;QUISSAMA;12555;12980;25535;0,491678089;0,508321911
314467;NOVA BELEM;1508;1559;3067;0,491685686;0,508314314
430400;CAMPO NOVO;2101;2172;4273;0,49169202;0,50830798
430570;CONDOR;3327;3439;6766;0,491723322;0,508276678
211030;SANTO ANTONIO DOS LOPES;7138;7378;14516;0,49173326;0,50826674
315680;SABINOPOLIS;7555;7809;15364;0,491733923;0,508266077
211280;VIANA;25990;26862;52852;0,491750549;0,508249451
350390;ARUJA;45465;46988;92453;0,491763382;0,508236618
430350;CAMAQUA;32795;33891;66686;0,491782383;0,508217617
293077;SOBRADINHO;11446;11828;23274;0,491793418;0,508206582
410420;CAMPO LARGO;66726;68952;135678;0,491796754;0,508203246
432010;SARANDI;12307;12717;25024;0,491807864;0,508192136
354970;SAO JOSE DO RIO PARDO;27196;28102;55298;0,491808022;0,508191978
260290;CABO DE SANTO AGOSTINHO;103672;107124;210796;0,491811989;0,508188011
311320;CARANDAI;12704;13127;25831;0,491812164;0,508187836
251510;SAO SEBASTIAO DE LAGOA DE ROCA;5800;5993;11793;0,49181718;0,50818282
290550;CALDEIRAO GRANDE;6616;6836;13452;0,491822777;0,508177223
350190;AMPARO;35975;37170;73145;0,491831294;0,508168706
431000;IBIRUBA;10070;10404;20474;0,491843313;0,508156687
260765;ITAMBE;17951;18544;36495;0,491875599;0,508124401
350400;ASSIS;52025;53743;105768;0,491878451;0,508121549
431225;MINAS DO LEAO;3999;4131;8130;0,491881919;0,508118081
313930;MANGA;8879;9172;18051;0,491884106;0,508115894
412240;ROLANDIA;33530;34635;68165;0,491894667;0,508105333
430155;AUREA;1730;1787;3517;0,491896503;0,508103497
350590;BATATAIS;31205;32233;63438;0,491897601;0,508102399
313940;MANHUACU;45291;46783;92074;0,491897821;0,508102179
412480;SAO JOAO;4979;5143;10122;0,491898834;0,508101166
352250;ITAPEVI;120089;124042;244131;0,491903937;0,508096063
430466;CAPAO DO LEAO;12525;12937;25462;0,491909512;0,508090488
432120;TAQUARA;28403;29337;57740;0,491912019;0,508087981
220415;FRANCISCO MACEDO;1582;1634;3216;0,491915423;0,508084577
240080;ANGICOS;5753;5942;11695;0,491919624;0,508080376
310350;ARAGUARI;58227;60134;118361;0,491944137;0,508055863
411070;IRATI;30225;31214;61439;0,491951366;0,508048634
431580;ROCA SALES;5685;5871;11556;0,491952233;0,508047767
431620;RONDINHA;2476;2557;5033;0,491953109;0,508046891
250260;IGARACY;2997;3095;6092;0,491956664;0,508043336
240070;ALTO DO RODRIGUES;7342;7581;14923;0,491992227;0,508007773
430730;ERVAL SECO;3295;3402;6697;0,492011348;0,507988652
250930;MATARACA;4252;4390;8642;0,492015737;0,507984263
353030;MIRASSOL;29899;30869;60768;0,492018826;0,507981174
432170;TRES COROAS;14243;14705;28948;0,492020174;0,507979826
260280;BUIQUE;29250;30198;59448;0,492026645;0,507973355
231160;REDENCAO;14386;14852;29238;0,492030919;0,507969081
260110;ARARIPINA;41972;43329;85301;0,492045814;0,507954186
350330;ARARAS;67282;69457;136739;0,492046892;0,507953108
510268;CAMPOS DE JULIO;3565;3680;7245;0,492063492;0,507936508
430676;ELDORADO DO SUL;20908;21582;42490;0,492068722;0,507931278
261540;TORITAMA;23171;23917;47088;0,492078661;0,507921339
220550;JOSE DE FREITAS;19416;20041;39457;0,492079986;0,507920014
270640;PAO DE ACUCAR;11961;12346;24307;0,492080471;0,507919529
355620;VALINHOS;65530;67639;133169;0,49208149;0,50791851
314110;MATOZINHOS;18930;19539;38469;0,492084536;0,507915464
261470;TACAIMBO;6320;6523;12843;0,492096862;0,507903138
330470;SANTO ANTONIO DE PADUA;21015;21690;42705;0,492096944;0,507903056
431190;MARCELINO RAMOS;2086;2153;4239;0,492097193;0,507902807
280550;POCO VERDE;11812;12191;24003;0,492105154;0,507894846
316590;SENADOR MODESTINO GONCALVES;1996;2060;4056;0,492110454;0,507889546
352750;LUCIANOPOLIS;1187;1225;2412;0,49212272;0,50787728
292310;OLINDINA;13963;14410;28373;0,492122793;0,507877207
290150;ANGUERA;5595;5774;11369;0,492127716;0,507872284
316550;SARDOA;3160;3261;6421;0,492135181;0,507864819
354520;SALTO;59440;61339;120779;0,492138534;0,507861466
260875;LAGOA GRANDE;12840;13250;26090;0,492142583;0,507857417
230350;CASCAVEL;35783;36923;72706;0,492160207;0,507839793
261153;QUIXABA;3345;3451;6796;0,492201295;0,507798705
220560;LANDRI SALES;2595;2677;5272;0,492223065;0,507776935
270550;MURICI;13993;14435;28428;0,492225974;0,507774026
250480;COREMAS;7599;7839;15438;0,492226972;0,507773028
261380;SAO VICENTE FERRER;8934;9216;18150;0,492231405;0,507768595
160030;MACAPA;257133;265224;522357;0,492255297;0,507744703
250820;LAGOA DE DENTRO;3817;3937;7754;0,492262058;0,507737942
430587;CORONEL BARROS;1241;1280;2521;0,492264974;0,507735026
330513;SAO JOSE DE UBA;3564;3676;7240;0,492265193;0,507734807
261410;SERTANIA;17815;18374;36189;0,492276659;0,507723341
230920;NOVA OLINDA;7777;8021;15798;0,492277503;0,507722497
110005;CEREJEIRAS;7920;8168;16088;0,492292392;0,507707608
230840;MISSAO VELHA;17509;18057;35566;0,492296013;0,507703987
292120;MIGUEL CALMON;12687;13084;25771;0,492297544;0,507702456
313110;INIMUTABA;3744;3861;7605;0,492307692;0,507692308
520455;CALDAZINHA;1920;1980;3900;0,492307692;0,507692308
410260;BARRACAO;5094;5253;10347;0,492316614;0,507683386
290485;CABACEIRAS DO PARAGUACU;9359;9651;19010;0,492319832;0,507680168
291685;ITATIM;7182;7406;14588;0,492322457;0,507677543
230500;GUARACIABA DO NORTE;20147;20774;40921;0,492338897;0,507661103
411450;MANOEL RIBAS;6655;6862;13517;0,492342976;0,507657024
311070;CAMBUQUIRA;6307;6503;12810;0,492349727;0,507650273
251520;SAO SEBASTIAO DO UMBUZEIRO;1740;1794;3534;0,492359932;0,507640068
330555;SEROPEDICA;41280;42561;83841;0,49236054;0,50763946
230310;CARIRE;9094;9376;18470;0,492365999;0,507634001
354920;SAO JOAO DAS DUAS PONTES;1258;1297;2555;0,492367906;0,507632094
251480;SAO JOSE DOS CORDEIROS;1776;1831;3607;0,492375936;0,507624064
251390;SAO BENTO;17061;17589;34650;0,492380952;0,507619048
316257;SAO JOAO DO MANTENINHA;2942;3033;5975;0,492384937;0,507615063
250760;JUAREZ TAVORA;3946;4068;8014;0,49238832;0,50761168
291390;IPIAU;22635;23334;45969;0,49239705;0,50760295
241200;SAO GONCALO DO AMARANTE;51663;53256;104919;0,492408429;0,507591571
350430;AVAI;2692;2775;5467;0,492408999;0,507591001
432140;TENENTE PORTELA;6591;6794;13385;0,492416885;0,507583115
352320;ITARARE;25005;25773;50778;0,49243767;0,50756233
420560;GALVAO;1335;1376;2711;0,492438215;0,507561785
350760;BRAGANCA PAULISTA;84870;87476;172346;0,492439627;0,507560373
330023;ARMACAO DOS BUZIOS;17265;17795;35060;0,492441529;0,507558471
311800;CONGONHAS;27496;28340;55836;0,492442152;0,507557848
353830;PIQUEROBI;1825;1881;3706;0,492444684;0,507555316
231050;PEDRA BRANCA;21352;22007;43359;0,492446782;0,507553218
354360;RIFAINA;1798;1853;3651;0,492467817;0,507532183
520920;GUAPO;6996;7210;14206;0,492467971;0,507532029
350260;APARECIDA D'OESTE;2030;2092;4122;0,492479379;0,507520621
150660;SANTA MARIA DO PARA;12375;12752;25127;0,49249811;0,50750189
430600;CRISSIUMAL;6535;6734;13269;0,492501319;0,507498681
412850;WENCESLAU BRAZ;9534;9824;19358;0,492509557;0,507490443
320500;SERRA;264365;272400;536765;0,492515347;0,507484653
314740;PARAOPEBA;12241;12613;24854;0,492516295;0,507483705
410930;GUARANIACU;5895;6074;11969;0,492522349;0,507477651
260890;LIMOEIRO;27655;28494;56149;0,492528807;0,507471193
290260;BAIXA GRANDE;10063;10368;20431;0,492535852;0,507464148
430980;IBIACA;2310;2380;4690;0,492537313;0,507462687
315053;PINGO-D'AGUA;2477;2552;5029;0,492543249;0,507456751
412035;PRANCHITA;2480;2555;5035;0,492552135;0,507447865
251140;PICUI;9229;9508;18737;0,492554838;0,507445162
421950;XANXERE;25756;26534;52290;0,492560719;0,507439281
430670;DONA FRANCISCA;1457;1501;2958;0,492562542;0,507437458
355390;TARABAI;3748;3861;7609;0,492574583;0,507425417
410540;CHOPINZINHO;9400;9683;19083;0,492585023;0,507414977
421930;VIDEIRA;26672;27473;54145;0,492603195;0,507396805
320313;JOAO NEIVA;8263;8511;16774;0,492607607;0,507392393
150810;TUCURUI;57441;59164;116605;0,492611809;0,507388191
120005;ASSIS BRASIL;3768;3881;7649;0,492613414;0,507386586
314080;MATIAS BARBOSA;7205;7421;14626;0,49261589;0,50738411
230380;CEDRO;12617;12995;25612;0,492620647;0,507379353
352700;LINDOIA;4040;4161;8201;0,492622851;0,507377149
351370;DESCALVADO;16797;17300;34097;0,492623985;0,507376015
230450;FRECHEIRINHA;6993;7202;14195;0,492638253;0,507361747
315430;RESPLENDOR;8570;8826;17396;0,492641987;0,507358013
314430;NANUQUE;19993;20590;40583;0,492644703;0,507355297
290410;BOQUIRA;10585;10901;21486;0,492646374;0,507353626
355410;TAUBATE;158053;162767;320820;0,492653201;0,507346799
250220;BOM JESUS;1275;1313;2588;0,492658423;0,507341577
431730;SANTA VITORIA DO PALMAR;14434;14864;29298;0,492661615;0,507338385
431940;SAO PEDRO DO SUL;7932;8168;16100;0,492670807;0,507329193
293317;VARZEDO;4303;4431;8734;0,492672315;0,507327685
350055;AGUAS DE SANTA BARBARA;3026;3116;6142;0,492673396;0,507326604
317180;VIRGINOPOLIS;5153;5306;10459;0,492685725;0,507314275
420660;GUARUJA DO SUL;2560;2636;5196;0,492686682;0,507313318
431860;SAO JOSE DO OURO;3405;3506;6911;0,492692809;0,507307191
220500;ITAINOPOLIS;5701;5870;11571;0,49269726;0,50730274
310230;ALVINOPOLIS;7457;7678;15135;0,492699042;0,507300958
210100;ARARI;14788;15226;30014;0,492703405;0,507296595
411745;OURO VERDE DO OESTE;2974;3062;6036;0,492710404;0,507289596
210270;CANTANHEDE;10956;11280;22236;0,492714517;0,507285483
350780;BRODOWSKI;12616;12989;25605;0,492716266;0,507283734
420480;CURITIBANOS;19727;20310;40037;0,492719235;0,507280765
230140;ARATUBA;5794;5965;11759;0,492728974;0,507271026
420430;CONCORDIA;37292;38391;75683;0,492739453;0,507260547
311970;CORONEL XAVIER CHAVES;1699;1749;3448;0,49274942;0,50725058
431950;SAO SEBASTIAO DO CAI;12891;13270;26161;0,492756393;0,507243607
293190;TUCANO;25083;25820;50903;0,492760741;0,507239259
320425;PONTO BELO;3950;4066;8016;0,492764471;0,507235529
351820;GUARARAPES;16388;16869;33257;0,49276844;0,50723156
510480;JACIARA;13648;14048;27696;0,492778741;0,507221259
410050;ALTONIA;10986;11307;22293;0,492800431;0,507199569
410040;ALMIRANTE TAMANDARE;59839;61581;121420;0,492826552;0,507173448
270290;GIRAU DO PONCIANO;20477;21072;41549;0,49283978;0,50716022
431280;NOVA ARACA;2410;2480;4890;0,492842536;0,507157464
410660;CRUZEIRO DO OESTE;10331;10631;20962;0,492844194;0,507155806
230195;BARREIRA;11195;11520;22715;0,492846137;0,507153863
315720;SANTA BARBARA;15709;16164;31873;0,492862297;0,507137703
350460;BADY BASSITT;8878;9135;18013;0,492866263;0,507133737
412410;SANTO ANTONIO DA PLATINA;22920;23583;46503;0,492871428;0,507128572
315460;RIBEIRAO DAS NEVES;168275;173140;341415;0,49287524;0,50712476
430020;AJURICABA;3426;3525;6951;0,492878722;0,507121278
314090;MATIPO;9413;9685;19098;0,492878835;0,507121165
240950;PEDRA GRANDE;1559;1604;3163;0,4928865;0,5071135
410320;BOM SUCESSO;3501;3602;7103;0,492890328;0,507109672
420550;FRAIBURGO;18101;18622;36723;0,492906353;0,507093647
230435;FORQUILHA;12165;12515;24680;0,492909238;0,507090762
220987;SAO JOAO DA FRONTEIRA;2999;3085;6084;0,492932281;0,507067719
250073;AMPARO;1116;1148;2264;0,492932862;0,507067138
420460;CRICIUMA;108147;111246;219393;0,492937332;0,507062668
210760;PALMEIRANDIA;9780;10060;19840;0,492943548;0,507056452
250153;BARAUNA;2481;2552;5033;0,492946553;0,507053447
250040;ALAGOA NOVA;10348;10644;20992;0,492949695;0,507050305
500400;GLORIA DE DOURADOS;4897;5037;9934;0,492953493;0,507046507
170550;COLINAS DO TOCANTINS;17880;18391;36271;0,492955805;0,507044195
230110;ARACATI;37165;38227;75392;0,492956812;0,507043188
432030;SELBACH;2521;2593;5114;0,492960501;0,507039499
421880;TURVO;6448;6632;13080;0,492966361;0,507033639
210055;AMAPA DO MARANHAO;3474;3573;7047;0,492975734;0,507024266
261460;TABIRA;14228;14632;28860;0,493000693;0,506999307
261510;TEREZINHA;3563;3664;7227;0,493012315;0,506987685
420845;ITAPOA;10731;11035;21766;0,493016631;0,506983369
430510;CAXIAS DO SUL;258202;265514;523716;0,493019117;0,506980883
500430;IGUATEMI;8023;8250;16273;0,493025257;0,506974743
250150;BANANEIRAS;10462;10758;21220;0,493025448;0,506974552
352260;ITAPIRA;37314;38369;75683;0,493030139;0,506969861
220695;NOVO SANTO ANTONIO;1486;1528;3014;0,493032515;0,506967485
314030;MARLIERIA;1987;2043;4030;0,493052109;0,506947891
231130;QUIXADA;43833;45066;88899;0,493065164;0,506934836
354770;SANTO ANASTACIO;10283;10572;20855;0,493071206;0,506928794
240700;LUIS GOMES;5017;5158;10175;0,493071253;0,506928747
412500;SAO JOAO DO IVAI;4880;5017;9897;0,493078711;0,506921289
350020;ADOLFO;1748;1797;3545;0,493088858;0,506911142
421580;SAO BENTO DO SUL;42562;43755;86317;0,493089426;0,506910574
230185;BANABUIU;9030;9283;18313;0,493092339;0,506907661
261220;SALGUEIRO;30356;31205;61561;0,493104401;0,506895599
314950;PEQUERI;1647;1693;3340;0,493113772;0,506886228
350130;ALVARES MACHADO;12367;12711;25078;0,493141399;0,506858601
261010;PALMEIRINA;3703;3806;7509;0,493141563;0,506858437
353730;PENAPOLIS;31611;32487;64098;0,493166713;0,506833287
230160;ASSARE;11608;11929;23537;0,493180949;0,506819051
354490;SALES OLIVEIRA;5969;6134;12103;0,493183508;0,506816492
290470;BUERAREMA;9010;9259;18269;0,493185177;0,506814823
260580;FREI MIGUELINHO;7710;7923;15633;0,493187488;0,506812512
314990;PERDOES;10642;10935;21577;0,493210363;0,506789637
270900;TANQUE D'ARCA;3016;3099;6115;0,49321341;0,50678659
250230;BOM SUCESSO;2435;2502;4937;0,493214503;0,506785497
280300;ITABAIANINHA;20913;21486;42399;0,493242765;0,506757235
292790;SANTA INES;5220;5363;10583;0,493243882;0,506756118
352470;JAGUARIUNA;29556;30365;59921;0,493249445;0,506750555
315480;RIO ACIMA;5191;5333;10524;0,493253516;0,506746484
411060;IPORA;6729;6913;13642;0,493256121;0,506743879
220110;AVELINO LOPES;5604;5757;11361;0,493266438;0,506733562
241260;SAO PAULO DO POTENGI;8809;9049;17858;0,493280323;0,506719677
411600;MIRASELVA;881;905;1786;0,493281075;0,506718925
510250;CACERES;47029;48310;95339;0,493281868;0,506718132
330130;CASIMIRO DE ABREU;22624;23240;45864;0,493284493;0,506715507
315700;SALINAS;20651;21213;41864;0,493287789;0,506712211
260795;JAQUEIRA;5738;5894;11632;0,49329436;0,50670564
315000;PESCADOR;2102;2159;4261;0,493311429;0,506688571
313310;ITANHANDU;7652;7859;15511;0,493327316;0,506672684
230970;PACATUBA;42254;43393;85647;0,493350614;0,506649386
260050;AGUAS BELAS;21670;22253;43923;0,493363386;0,506636614
293360;XIQUE-XIQUE;22972;23590;46562;0,493363687;0,506636313
230428;EUSEBIO;27153;27882;55035;0,493376942;0,506623058
241140;SANTANA DO MATOS;5826;5982;11808;0,493394309;0,506605691
220200;BURITI DOS LOPES;9785;10047;19832;0,493394514;0,506605486
312290;DONA EUSEBIA;3288;3376;6664;0,493397359;0,506602641
317010;UBERABA;167892;172385;340277;0,493398026;0,506601974
313950;MANHUMIRIM;11296;11598;22894;0,493404385;0,506595615
150380;JACUNDA;29860;30657;60517;0,493415073;0,506584927
521140;ITAUCU;4425;4543;8968;0,493421053;0,506578947
352390;ITU;87411;89739;177150;0,493429297;0,506570703
420570;GAROPABA;11877;12193;24070;0,493435812;0,506564188
261240;SANHARO;13475;13833;27308;0,493445144;0,506554856
432065;SILVEIRA MARTINS;1167;1198;2365;0,493446089;0,506553911
412865;VIRMOND;1999;2052;4051;0,493458405;0,506541595
270810;SANTANA DO MUNDAU;5249;5388;10637;0,493466203;0,506533797
351740;GUAIRA;20372;20911;41283;0,493471889;0,506528111
351050;CARAGUATATUBA;61780;63414;125194;0,493474128;0,506525872
211174;SENADOR ALEXANDRE COSTA;5569;5716;11285;0,49348693;0,50651307
210650;MATINHA;11642;11949;23591;0,493493281;0,506506719
240880;PARAZINHO;2619;2688;5307;0,493499152;0,506500848
411260;JARDIM OLINDA;646;663;1309;0,493506494;0,506493506
420425;COCAL DO SUL;8368;8588;16956;0,493512621;0,506487379
421360;PORTO UNIAO;17611;18074;35685;0,49351268;0,50648732
210870;PIO XII;10499;10775;21274;0,493513209;0,506486791
420590;GASPAR;35497;36428;71925;0,493527981;0,506472019
110030;VILHENA;51583;52934;104517;0,493536937;0,506463063
260390;CARNAIBA;9706;9960;19666;0,493542154;0,506457846
316690;SERRANIA;3784;3883;7667;0,493543759;0,506456241
420820;ITAJAI;111846;114771;226617;0,49354638;0,50645362
270642;PARICONHA;5205;5341;10546;0,493552058;0,506447942
270280;FLEXEIRAS;6329;6494;12823;0,493566248;0,506433752
220950;SANTO INACIO DO PIAUI;1880;1929;3809;0,493567866;0,506432134
260070;ALIANCA;18957;19451;38408;0,493569048;0,506430952
221037;SAO LUIS DO PIAUI;1307;1341;2648;0,49358006;0,50641994
412190;RIBEIRAO DO PINHAL;6352;6517;12869;0,493589245;0,506410755
316300;SAO JOSE DA SAFIRA;2118;2173;4291;0,493591237;0,506408763
412590;SAO PEDRO DO PARANA;1118;1147;2265;0,493598234;0,506401766
411110;ITAMBE;3016;3094;6110;0,493617021;0,506382979
270180;CARNEIROS;4723;4845;9568;0,493624582;0,506375418
220325;CURRALINHOS;2209;2266;4475;0,493631285;0,506368715
230630;ITAPAGE;26384;27064;53448;0,493638677;0,506361323
280445;NOSSA SENHORA APARECIDA;4355;4467;8822;0,493652233;0,506347767
280600;RIBEIROPOLIS;9326;9565;18891;0,493674236;0,506325764
311530;CATAGUASES;37491;38451;75942;0,493679387;0,506320613
261330;SAO JOAQUIM DO MONTE;10584;10855;21439;0,493679743;0,506320257
430820;FLORES DA CUNHA;15478;15874;31352;0,493684613;0,506315387
320020;ALEGRE;14746;15123;29869;0,493689109;0,506310891
291250;IBIPITANGA;7400;7589;14989;0,493695377;0,506304623
420760;IPIRA;2156;2211;4367;0,493702771;0,506297229
241480;VERA CRUZ;6314;6475;12789;0,493705528;0,506294472
270040;ATALAIA;23471;24069;47540;0,49371056;0,50628944
270060;BARRA DE SAO MIGUEL;4164;4270;8434;0,493715912;0,506284088
230490;GROAIRAS;5539;5680;11219;0,493716017;0,506283983
410657;CRUZEIRO DO IGUACU;2088;2141;4229;0,493733743;0,506266257
421860;TROMBUDO CENTRAL;3706;3800;7506;0,493738343;0,506261657
412600;SAO SEBASTIAO DA AMOREIRA;4377;4488;8865;0,493739425;0,506260575
220580;LUZILANDIA;12601;12920;25521;0,493750245;0,506249755
291560;ITAMARAJU;31809;32614;64423;0,493752231;0,506247769
231010;PALMACIA;6692;6861;13553;0,493765218;0,506234782
432145;TEUTONIA;16924;17351;34275;0,49377097;0,50622903
251670;TEIXEIRA;7571;7762;15333;0,493771604;0,506228396
230010;ABAIARA;5908;6057;11965;0,493773506;0,506226494
110045;BURITIS;20266;20777;41043;0,493774822;0,506225178
353250;NEVES PAULISTA;4403;4514;8917;0,493775934;0,506224066
430085;ARAMBARE;1750;1794;3544;0,493792325;0,506207675
521205;JESUPOLIS;1233;1264;2497;0,493792551;0,506207449
220860;PRATA DO PIAUI;1555;1594;3149;0,493807558;0,506192442
500625;NOVO HORIZONTE DO SUL;1756;1800;3556;0,493813273;0,506186727
320230;GUACUI;15492;15880;31372;0,493816142;0,506183858
410310;BOCAIUVA DO SUL;6572;6736;13308;0,493838293;0,506161707
420730;IMBITUBA;22574;23137;45711;0,493841745;0,506158255
510500;JAURU;4137;4240;8377;0,493852214;0,506147786
280220;FEIRA NOVA;2774;2843;5617;0,493857931;0,506142069
432260;VENANCIO AIRES;35742;36631;72373;0,493858207;0,506141793
420380;CANOINHAS;26944;27614;54558;0,493859746;0,506140254
291072;EUNAPOLIS;56973;58387;115360;0,493871359;0,506128641
353205;MOTUCA;2386;2445;4831;0,493893604;0,506106396
293340;WAGNER;4614;4728;9342;0,493898523;0,506101477
520235;ARENOPOLIS;1216;1246;2462;0,493907392;0,506092608
351519;ESPIRITO SANTO DO TURVO;2433;2493;4926;0,493909866;0,506090134
251630;SUME;8444;8652;17096;0,493916706;0,506083294
313680;JURAMENTO;2153;2206;4359;0,493920624;0,506079376
230560;INDEPENDENCIA;12939;13257;26196;0,493930371;0,506069629
313190;ITABIRITO;26177;26819;52996;0,493942939;0,506057061
314000;MARIANA;30541;31289;61830;0,493951156;0,506048844
317050;URUCANIA;5104;5229;10333;0,493951418;0,506048582
210467;GOVERNADOR NUNES FREIRE;12597;12905;25502;0,493961258;0,506038742
500520;LADARIO;11875;12165;24040;0,493968386;0,506031614
351390;DIVINOLANDIA;5447;5580;11027;0,493969348;0,506030652
432190;TRES PASSOS;11756;12043;23799;0,493970335;0,506029665
316470;SAO SEBASTIAO DO PARAISO;35525;36390;71915;0,493985956;0,506014044
421010;MAFRA;28071;28754;56825;0,493990321;0,506009679
430990;IBIRAIARAS;3590;3677;7267;0,494014036;0,505985964
310770;BOM JESUS DO AMPARO;3054;3128;6182;0,494014882;0,505985118
500840;VICENTINA;3021;3094;6115;0,494031071;0,505968929
420455;CORREIA PINTO;6084;6231;12315;0,494031669;0,505968331
230600;IRACEMA;7090;7261;14351;0,494042227;0,505957773
220230;CANTO DO BURITI;10536;10790;21326;0,494044828;0,505955172
221093;SUSSUAPARA;3360;3441;6801;0,494044993;0,505955007
261610;VERDEJANTE;4729;4843;9572;0,494045132;0,505954868
210845;PERITORO;11625;11905;23530;0,494050149;0,505949851
210177;BELA VISTA DO MARANHAO;5606;5741;11347;0,494051291;0,505948709
500660;PONTA PORA;47093;48227;95320;0,494051616;0,505948384
320490;SAO MATEUS;66514;68115;134629;0,49405403;0,50594597
430900;GIRUA;7771;7958;15729;0,494055566;0,505944434
421480;RIO DO SUL;36032;36899;72931;0,494056026;0,505943974
291380;IPECAETA;7030;7199;14229;0,494061424;0,505938576
231320;TAMBORIL;12944;13255;26199;0,494064659;0,505935341
240490;ITAU;2923;2993;5916;0,49408384;0,50591616
292850;SANTA TERESINHA;5198;5322;10520;0,494106464;0,505893536
211270;VARGEM GRANDE;28566;29247;57813;0,494110321;0,505889679
210960;ROSARIO;21367;21876;43243;0,494114654;0,505885346
312720;FUNILANDIA;2191;2243;4434;0,49413622;0,50586378
411220;JANIOPOLIS;2445;2503;4948;0,494139046;0,505860954
220620;MIGUEL ALVES;16752;17149;33901;0,494144715;0,505855285
240420;GOIANINHA;13344;13660;27004;0,494149015;0,505850985
251090;PAULISTA;6133;6278;12411;0,494158408;0,505841592
260830;JUPI;7416;7591;15007;0,494169388;0,505830612
411960;PITANGA;14670;15016;29686;0,494172337;0,505827663
261485;TAMANDARE;11787;12065;23852;0,494172396;0,505827604
315400;RAUL SOARES;11694;11969;23663;0,494189241;0,505810759
291300;IBITIARA;8136;8327;16463;0,494199113;0,505800887
431590;RODEIO BONITO;2900;2968;5868;0,494205862;0,505794138
250850;LIVRAMENTO;3595;3679;7274;0,49422601;0,50577399
420860;JABORA;1927;1972;3899;0,49422929;0,50577071
420520;ERVAL VELHO;2186;2237;4423;0,494234682;0,505765318
410730;DOUTOR CAMARGO;2959;3028;5987;0,494237515;0,505762485
355540;UBATUBA;45875;46944;92819;0,494241481;0,505758519
315840;SANTANA DE CATAGUASES;1932;1977;3909;0,494244052;0,505755948
355320;TAIUVA;2749;2813;5562;0,494246674;0,505753326
350790;BROTAS;12288;12574;24862;0,49424825;0,50575175
230790;MARTINOPOLE;5638;5769;11407;0,494257912;0,505742088
220605;MASSAPE DO PIAUI;3191;3265;6456;0,494268897;0,505731103
355300;TAGUAI;7125;7290;14415;0,494276795;0,505723205
221030;SAO JULIAO;3153;3226;6379;0,4942781;0,5057219
431417;PEDRAS ALTAS;953;975;1928;0,494294606;0,505705394
314100;MATO VERDE;6113;6254;12367;0,494299345;0,505700655
230620;ITAICABA;3907;3997;7904;0,49430668;0,50569332
230523;HORIZONTE;34448;35240;69688;0,49431753;0,50568247
431936;SAO PEDRO DAS MISSOES;1001;1024;2025;0,494320988;0,505679012
431890;SAO LUIZ GONZAGA;16374;16750;33124;0,494324357;0,505675643
210470;GRACA ARANHA;3095;3166;6261;0,494329979;0,505670021
354740;SANTA RITA D'OESTE;1224;1252;2476;0,494345719;0,505654281
421350;PORTO BELO;11106;11360;22466;0,494347013;0,505652987
230130;ARARIPE;10731;10976;21707;0,494356659;0,505643341
510710;SAO JOSE DOS QUATRO MARCOS;9288;9500;18788;0,494358101;0,505641899
314760;PASSA QUATRO;8127;8312;16439;0,494373137;0,505626863
260080;ALTINHO;11369;11627;22996;0,494390329;0,505609671
500769;SAO GABRIEL DO OESTE;13675;13985;27660;0,49439624;0,50560376
280690;SAO FRANCISCO;1897;1940;3837;0,494396664;0,505603336
241060;RAFAEL GODEIRO;1589;1625;3214;0,494399502;0,505600498
351560;FERNANDO PRESTES;2870;2935;5805;0,494401378;0,505598622
421170;ORLEANS;11451;11710;23161;0,494408704;0,505591296
412650;SERTANOPOLIS;8136;8320;16456;0,494409334;0,505590666
412130;RANCHO ALEGRE;1859;1901;3760;0,494414894;0,505585106
420300;CACADOR;39563;40454;80017;0,494432433;0,505567567
230870;MORADA NOVA;30453;31137;61590;0,494447151;0,505552849
231325;TARRAFAS;4230;4325;8555;0,494447691;0,505552309
431675;SANTA CLARA DO SUL;3340;3415;6755;0,494448557;0,505551443
230740;JUCAS;12336;12613;24949;0,494448675;0,505551325
313780;LAMBARI;10381;10614;20995;0,49445106;0,50554894
412740;TERRA ROXA;8684;8878;17562;0,494476711;0,505523289
312040;CRISTIANO OTONI;2552;2609;5161;0,494477814;0,505522186
250620;FREI MARTINHO;1478;1511;2989;0,494479759;0,505520241
210490;GUIMARAES;5917;6049;11966;0,494484372;0,505515628
316880;TIRADENTES;4035;4125;8160;0,494485294;0,505514706
320480;SAO JOSE DO CALCADO;5210;5326;10536;0,494495065;0,505504935
210660;MATOES;16862;17237;34099;0,494501305;0,505498695
312825;GUARACIAMA;2475;2530;5005;0,494505495;0,505494505
293150;TEOFILANDIA;11171;11419;22590;0,494510846;0,505489154
240930;PATU;6360;6501;12861;0,494518311;0,505481689
291320;IBOTIRAMA;13390;13686;27076;0,494533905;0,505466095
432254;VALE REAL;2990;3056;6046;0,494541846;0,505458154
220850;PORTO;6254;6392;12646;0,494543729;0,505456271
500070;ANASTACIO;12530;12806;25336;0,494553205;0,505446795
412390;SANTA MARIANA;5699;5824;11523;0,494576065;0,505423935
220610;MATIAS OLIMPIO;5430;5549;10979;0,494580563;0,505419437
430512;CERRITO;2970;3035;6005;0,494587843;0,505412157
315030;PIEDADE DO RIO GRANDE;2194;2242;4436;0,49458972;0,50541028
291060;ESPLANADA;18746;19156;37902;0,494591314;0,505408686
431420;PEDRO OSORIO;3800;3883;7683;0,494598464;0,505401536
431240;MONTENEGRO;32722;33435;66157;0,494611303;0,505388697
221070;SIMOES;7253;7411;14664;0,494612657;0,505387343
411880;PEABIRU;6933;7084;14017;0,494613683;0,505386317
211140;SAO LUIS GONZAGA DO MARANHAO;9200;9400;18600;0,494623656;0,505376344
350350;AREIAS;1932;1974;3906;0,494623656;0,505376344
240870;PARAU;1846;1886;3732;0,494640943;0,505359057
270750;PORTO REAL DO COLEGIO;9971;10187;20158;0,494642326;0,505357674
354580;SANTA BARBARA D'OESTE;96595;98683;195278;0,494653776;0,505346224
261150;QUIPAPA;13014;13295;26309;0,494659622;0,505340378
314060;MATERLANDIA;2184;2231;4415;0,494677237;0,505322763
314870;PEDRA AZUL;12037;12296;24333;0,494678009;0,505321991
240100;APODI;17761;18143;35904;0,494680258;0,505319742
240710;MACAIBA;40974;41854;82828;0,494687787;0,505312213
351470;ECHAPORA;2981;3045;6026;0,494689678;0,505310322
230465;GRACA;7131;7284;14415;0,494693028;0,505306972
522150;TURVANIA;2239;2287;4526;0,494697304;0,505302696
522130;TRES RANCHOS;1400;1430;2830;0,494699647;0,505300353
420170;ASCURRA;3968;4053;8021;0,494701409;0,505298591
250250;BOQUEIRAO;8872;9062;17934;0,494702799;0,505297201
231260;SAO LUIS DO CURU;6474;6612;13086;0,494727189;0,505272811
313240;ITAJUBA;48376;49406;97782;0,494733182;0,505266818
250870;MAE D'AGUA;1973;2015;3988;0,494734203;0,505265797
432370;VISTA GAUCHA;1414;1444;2858;0,494751575;0,505248425
280410;MOITA BONITA;5621;5740;11361;0,494762785;0,505237215
292273;NOVA FATIMA;3874;3956;7830;0,494763729;0,505236271
354350;RIVERSUL;2654;2710;5364;0,494780015;0,505219985
270120;CACIMBINHAS;5403;5517;10920;0,49478022;0,50521978
330480;SAO FIDELIS;19173;19576;38749;0,494799866;0,505200134
220690;NOVO ORIENTE DO PIAUI;3240;3308;6548;0,494807575;0,505192425
250080;ARACAGI;8341;8516;16857;0,494809278;0,505190722
521385;MORRO AGUDO DE GOIAS;1097;1120;2217;0,49481281;0,50518719
353920;PIRAPOZINHO;13842;14132;27974;0,494816615;0,505183385
312360;ELOI MENDES;14130;14426;28556;0,494817201;0,505182799
261618;VERTENTE DO LERIO;3724;3802;7526;0,494817964;0,505182036
230980;PACOTI;6093;6220;12313;0,494842849;0,505157151
311230;CAPELINHA;18963;19358;38321;0,494846168;0,505153832
250340;CACIMBA DE AREIA;1835;1873;3708;0,494875944;0,505124056
250990;NATUBA;5171;5278;10449;0,494879893;0,505120107
310800;BOM SUCESSO;8716;8896;17612;0,494889848;0,505110152
316295;SAO JOSE DA LAPA;12120;12370;24490;0,494895876;0,505104124
292010;MAIRI;9173;9362;18535;0,494901538;0,505098462
251610;SOLEDADE;7528;7683;15211;0,494905003;0,505094997
240850;OURO BRANCO;2382;2431;4813;0,49490962;0,50509038
220985;SAO JOAO DA CANABRAVA;2286;2333;4619;0,494912319;0,505087681
210450;GOVERNADOR ARCHER;5410;5521;10931;0,494922697;0,505077303
251740;ZABELE;1123;1146;2269;0,494931688;0,505068312
330452;RIO DAS OSTRAS;78958;80571;159529;0,494944493;0,505055507
240560;JARDIM DE PIRANHAS;7446;7598;15044;0,494948152;0,505051848
120020;CRUZEIRO DO SUL;44427;45333;89760;0,494953209;0,505046791
314995;PERIQUITO;3335;3403;6738;0,494953992;0,505046008
260770;ITAPETIM;6678;6814;13492;0,494959976;0,505040024
420785;IRATI;934;953;1887;0,494965554;0,505034446
240660;LAGOA SALGADA;4132;4216;8348;0,494968855;0,505031145
221110;UNIAO;22100;22549;44649;0,494971892;0,505028108
150700;SANTO ANTONIO DO TAUA;16011;16335;32346;0,494991653;0,505008347
315120;PIRAPORA;28138;28707;56845;0,494995162;0,505004838
240330;ENCANTO;2820;2877;5697;0,494997367;0,505002633
320250;IBIRACU;6287;6414;12701;0,495000394;0,504999606
411722;NOVA SANTA ROSA;4114;4197;8311;0,495006618;0,504993382
432080;SOLEDADE;15379;15688;31067;0,495026877;0,504973123
241320;SENADOR GEORGINO AVELINO;2241;2286;4527;0,495029821;0,504970179
420700;ICARA;28739;29316;58055;0,495030574;0,504969426
261170;RIACHO DAS ALMAS;10269;10475;20744;0,495034709;0,504965291
421335;PONTE ALTA DO NORTE;1696;1730;3426;0,495037945;0,504962055
314790;PASSOS;57410;58560;115970;0,495041821;0,504958179
431339;NOVO CABRAIS;2102;2144;4246;0,495054169;0,504945831
353650;PAULINIA;56688;57820;114508;0,495057114;0,504942886
352640;LARANJAL PAULISTA;14380;14667;29047;0,495059731;0,504940269
290120;ANAGE;10510;10719;21229;0,495077488;0,504922512
231270;SENADOR POMPEU;12584;12834;25418;0,495082225;0,504917775
280340;JAPOATA;6645;6777;13422;0,4950827;0,5049173
430105;ARROIO DO SAL;5190;5293;10483;0,495087284;0,504912716
220030;ALTO LONGA;7115;7256;14371;0,495094287;0,504905713
220170;BERTOLINIA;2729;2783;5512;0,495101597;0,504898403
353070;MOGI GUACU;76321;77825;154146;0,495121508;0,504878492
150150;BENEVIDES;32074;32706;64780;0,495121951;0,504878049
240730;MARCELINO VIEIRA;4122;4203;8325;0,495135135;0,504864865
311060;CAMBUI;14888;15180;30068;0,495144339;0,504855661
510779;SANTO ANTONIO DO LESTE;2703;2756;5459;0,495145631;0,504854369
241050;RAFAEL FERNANDES;2554;2604;5158;0,49515316;0,50484684
355670;VINHEDO;40364;41152;81516;0,495166593;0,504833407
211245;TURILANDIA;12930;13182;26112;0,495174632;0,504825368
411890;PEROLA;5648;5758;11406;0,495177977;0,504822023
310810;BONFIM;3393;3459;6852;0,495183888;0,504816112
292580;QUEIMADAS;12592;12836;25428;0,495202139;0,504797861
260020;AFRANIO;9895;10086;19981;0,495220459;0,504779541
521973;SANTO ANTONIO DE GOIAS;3265;3328;6593;0,495222205;0,504777795
251200;POCINHOS;9334;9514;18848;0,495224958;0,504775042
350880;CAFELANDIA;8873;9044;17917;0,495227996;0,504772004
431455;PIRAPO;1092;1113;2205;0,495238095;0,504761905
231395;VARJOTA;9172;9348;18520;0,49524838;0,50475162
330411;PORTO REAL;10031;10223;20254;0,495260196;0,504739804
251100;PEDRA BRANCA;1883;1919;3802;0,49526565;0,50473435
431550;RESTINGA SECA;7777;7925;15702;0,495287225;0,504712775
352240;ITAPEVA;47172;48069;95241;0,495290894;0,504709106
240040;AGUA NOVA;1631;1662;3293;0,495293046;0,504706954
270300;IBATEGUARA;7745;7892;15637;0,49529961;0,50470039
313520;JANUARIA;33660;34298;67958;0,495305924;0,504694076
411270;JATAIZINHO;6284;6403;12687;0,49531016;0,50468984
221010;SAO JOSE DO PEIXE;1851;1886;3737;0,495317099;0,504682901
354540;SALTO GRANDE;4654;4742;9396;0,495317156;0,504682844
500740;RIO VERDE DE MATO GROSSO;9919;10106;20025;0,495330836;0,504669164
313450;ITUTINGA;1857;1892;3749;0,495332089;0,504667911
316650;SERRA AZUL DE MINAS;2126;2166;4292;0,495340168;0,504659832
411560;MATELANDIA;9048;9218;18266;0,495346545;0,504653455
290430;BREJOES;7012;7143;14155;0,49537266;0,50462734
420910;JOINVILLE;299559;305149;604708;0,495377934;0,504622066
230763;MADALENA;9923;10108;20031;0,495382158;0,504617842
352540;JERIQUARA;1557;1586;3143;0,495386573;0,504613427
220120;BARRAS;23431;23867;47298;0,495390926;0,504609074
231195;SALITRE;8280;8434;16714;0,495393084;0,504606916
410405;CAMPO BONITO;1830;1864;3694;0,495397943;0,504602057
251220;PRATA;2113;2152;4265;0,495427902;0,504572098
431247;MORRO REUTER;3255;3315;6570;0,49543379;0,50456621
310630;BELO ORIENTE;13514;13763;27277;0,495435715;0,504564285
280620;SALGADO;9934;10117;20051;0,495436637;0,504563363
250290;BREJO DOS SANTOS;3210;3269;6479;0,495446828;0,504553172
291120;GANDU;16240;16538;32778;0,495454268;0,504545732
352930;MATAO;41653;42416;84069;0,495462061;0,504537939
314140;MEDINA;10257;10444;20701;0,49548331;0,50451669
352340;ITATIBA;61566;62688;124254;0,495485055;0,504514945
411350;LOANDA;11591;11802;23393;0,495490104;0,504509896
210590;LAGO VERDE;8111;8258;16369;0,495509805;0,504490195
412627;SAUDADE DO IGUACU;2764;2814;5578;0,495518107;0,504481893
251000;NAZAREZINHO;3603;3668;7271;0,495530188;0,504469812
221050;SAO PEDRO DO PIAUI;7114;7242;14356;0,495541934;0,504458066
420740;IMBUIA;3114;3170;6284;0,495544239;0,504455761
500500;JARDIM;13070;13305;26375;0,495545024;0,504454976
431150;LAVRAS DO SUL;3672;3738;7410;0,495546559;0,504453441
270644;PARIPUEIRA;6682;6802;13484;0,495550282;0,504449718
330550;SAQUAREMA;45560;46378;91938;0,49555135;0,50444865
355645;VARGEM GRANDE PAULISTA;26916;27399;54315;0,495553714;0,504446286
431760;SANTO ANTONIO DA PATRULHA;21506;21891;43397;0,49556421;0,50443579
280330;JAPARATUBA;9449;9618;19067;0,495568259;0,504431741
311370;CARLOS CHAGAS;9176;9340;18516;0,495571398;0,504428602
521760;PLANALTINA;45269;46076;91345;0,495582681;0,504417319
315990;SANTO ANTONIO DO AMPARO;9266;9431;18697;0,495587527;0,504412473
250350;CACIMBA DE DENTRO;8509;8660;17169;0,495602539;0,504397461
316620;SENHORA DOS REMEDIOS;5191;5283;10474;0,495608173;0,504391827
150790;SOURE;12763;12989;25752;0,495611991;0,504388009
313210;ITACARAMBI;9008;9167;18175;0,49562586;0,50437414
311960;CORONEL PACHECO;1534;1561;3095;0,495638126;0,504361874
292550;PRADO;13984;14230;28214;0,495640462;0,504359538
150320;IGARAPE-ACU;19446;19788;39234;0,495641535;0,504358465
240910;PASSA E FICA;6774;6893;13667;0,495646448;0,504353552
313430;ITUMIRIM;2963;3015;5978;0,495650719;0,504349281
316800;TAIOBEIRAS;17176;17477;34653;0,495656942;0,504343058
292650;RIBEIRA DO AMPARO;7252;7379;14631;0,4956599;0,5043401
211010;SANTA QUITERIA DO MARANHAO;12830;13054;25884;0,495673003;0,504326997
431041;INHACORA;1094;1113;2207;0,495695514;0,504304486
241170;SAO BENTO DO TRAIRI;2251;2290;4541;0,495705792;0,504294208
171820;PORTO NACIONAL;26579;27039;53618;0,495710396;0,504289604
521486;NOVA GLORIA;3997;4066;8063;0,495721196;0,504278804
210130;BACURI;9283;9443;18726;0,495727865;0,504272135
170215;ARAGUANA;2903;2953;5856;0,495730874;0,504269126
110025;PRESIDENTE MEDICI;9005;9160;18165;0,495733554;0,504266446
240830;NOVA CRUZ;18617;18937;37554;0,495739468;0,504260532
522200;VIANOPOLIS;6984;7104;14088;0,495741056;0,504258944
353860;PIRACAIA;13691;13926;27617;0,495745374;0,504254626
350210;ANDRADINA;28379;28866;57245;0,495746353;0,504253647
314070;MATEUS LEME;15681;15950;31631;0,495747842;0,504252158
210275;CAPINZAL DO NORTE;5422;5515;10937;0,495748377;0,504251623
270560;NOVO LINO;6364;6473;12837;0,49575446;0,50424554
500290;CASSILANDIA;10938;11125;22063;0,495762136;0,504237864
270850;SAO LUIS DO QUITUNDE;17265;17560;34825;0,495764537;0,504235463
431342;NOVO MACHADO;1582;1609;3191;0,495769351;0,504230649
421640;SAO JOAO DO SUL;3635;3697;7332;0,495771959;0,504228041
421120;MORRO DA FUMACA;8971;9124;18095;0,495772313;0,504227687
316280;SAO JOAO EVANGELISTA;7814;7947;15761;0,495780725;0,504219275
330080;CACHOEIRAS DE MACACU;29575;30077;59652;0,495792262;0,504207738
312750;GONZAGA;3066;3118;6184;0,495795602;0,504204398
260100;ANGELIM;5603;5698;11301;0,495796832;0,504203168
220515;JACOBINA DO PIAUI;2835;2883;5718;0,495802728;0,504197272
510720;RIO BRANCO;2552;2595;5147;0,495822809;0,504177191
314585;ORATORIOS;2316;2355;4671;0,495825305;0,504174695
320290;ITARANA;5173;5260;10433;0,495830538;0,504169462
351590;FLOREAL;1430;1454;2884;0,495839112;0,504160888
280170;CRISTINAPOLIS;9015;9166;18181;0,495847313;0,504152687
350395;ASPASIA;900;915;1815;0,495867769;0,504132231
431040;INDEPENDENCIA;3002;3052;6054;0,495870499;0,504129501
350490;BANANAL;5474;5565;11039;0,49587825;0,50412175
430850;FREDERICO WESTPHALEN;15707;15968;31675;0,495880032;0,504119968
290580;CAMAMU;17576;17868;35444;0,495880826;0,504119174
310500;BALDIM;3858;3922;7780;0,495886889;0,504113111
231080;PEREIRO;8111;8245;16356;0,495903644;0,504096356
355400;TATUI;61559;62575;124134;0,495907648;0,504092352
353910;PIRAPORA DO BOM JESUS;9647;9806;19453;0,495913227;0,504086773
520160;ARACU;1711;1739;3450;0,495942029;0,504057971
430558;COLINAS;1223;1243;2466;0,49594485;0,50405515
432250;VACARIA;33187;33729;66916;0,495950146;0,504049854
411885;PEROBAL;3072;3122;6194;0,495963836;0,504036164
251650;TAPEROA;7690;7815;15505;0,495969042;0,504030958
431265;NAO-ME-TOQUE;8871;9015;17886;0,495974505;0,504025495
240500;JACANA;4633;4708;9341;0,495985441;0,504014559
431180;MARAU;22579;22944;45523;0,495991037;0,504008963
352660;LAVRINHAS;3651;3710;7361;0,495992392;0,504007608
352790;LUTECIA;1301;1322;2623;0,49599695;0,50400305
110006;COLORADO DO OESTE;7546;7667;15213;0,496023138;0,503976862
320460;SANTA TERESA;11832;12021;23853;0,496038234;0,503961766
431960;SAO SEPE;11653;11839;23492;0,496041206;0,503958794
510626;NOVO MUNDO;4735;4810;9545;0,496071241;0,503928759
522180;URUTAI;1516;1540;3056;0,496073298;0,503926702
170755;FATIMA;1897;1927;3824;0,496077406;0,503922594
315590;RIO PRETO;2725;2768;5493;0,496085928;0,503914072
316900;TOCANTINS;8319;8450;16769;0,496093983;0,503906017
410347;CAFEZAL DO SUL;1972;2003;3975;0,496100629;0,503899371
432290;VIADUTOS;2296;2332;4628;0,496110631;0,503889369
354515;SALTINHO;4216;4282;8498;0,496116733;0,503883267
410460;CAPITAO LEONIDAS MARQUES;7882;8005;15887;0,49612891;0,50387109
421185;OURO VERDE;1090;1107;2197;0,496131088;0,503868912
354320;RIBEIRAO DO SUL;2251;2286;4537;0,496142826;0,503857174
231170;RERIUTABA;9069;9210;18279;0,496143115;0,503856885
231060;PENAFORTE;4568;4639;9207;0,496144238;0,503855762
350450;AVARE;45543;46249;91792;0,496154349;0,503845651
220820;PIO IX;9175;9317;18492;0,496160502;0,503839498
520710;DIORAMA;1229;1248;2477;0,496164715;0,503835285
430860;GARIBALDI;17760;18034;35794;0,496172543;0,503827457
170360;BRASILANDIA DO TOCANTINS;1102;1119;2221;0,496172895;0,503827105
521250;LUZIANIA;106502;108143;214645;0,496177409;0,503822591
315800;SANTA MARIA DE ITABIRA;5392;5475;10867;0,496181099;0,503818901
410390;CAMPINA DA LAGOA;6891;6997;13888;0,496183756;0,503816244
291090;FIRMINO ALVES;2799;2842;5641;0,496188619;0,503811381
510675;PONTES E LACERDA;22878;23227;46105;0,496215161;0,503784839
354760;SANTA ROSA DE VITERBO;13378;13582;26960;0,496216617;0,503783383
411980;PLANALTO;6642;6743;13385;0,49622712;0,50377288
251230;PRINCESA ISABEL;11785;11964;23749;0,49623142;0,50376858
353390;OLIMPIA;27530;27947;55477;0,496241686;0,503758314
350040;AGUAS DA PRATA;4100;4162;8262;0,496247882;0,503752118
210515;IGARAPE DO MEIO;7181;7289;14470;0,496268141;0,503731859
251615;SOSSEGO;1802;1829;3631;0,496282016;0,503717984
430495;CASEIROS;1602;1626;3228;0,496282528;0,503717472
314880;PEDRA DO ANTA;1469;1491;2960;0,496283784;0,503716216
420420;CHAPECO;112950;114637;227587;0,496293725;0,503706275
261030;PARANATAMA;5761;5847;11608;0,496295658;0,503704342
314960;PEQUI;2212;2245;4457;0,496297958;0,503702042
411725;NOVA PRATA DO IGUACU;5231;5309;10540;0,49629981;0,50370019
110180;VALE DO PARAISO;3221;3269;6490;0,496302003;0,503697997
521200;JAUPACI;1411;1432;2843;0,496306718;0,503693282
355240;SUMARE;143867;146008;289875;0,496307029;0,503692971
311410;CARMO DE MINAS;7460;7571;15031;0,496307631;0,503692369
421970;XAXIM;14519;14735;29254;0,496308197;0,503691803
230170;AURORA;12193;12374;24567;0,496316197;0,503683803
420207;BALNEARIO GAIVOTA;5726;5811;11537;0,4963162;0,5036838
311870;COQUEIRAL;4516;4583;9099;0,496318277;0,503681723
172120;TOCANTINOPOLIS;11326;11494;22820;0,496319018;0,503680982
210375;DAVINOPOLIS;6414;6509;12923;0,496324383;0,503675617
290210;ARACI;27250;27653;54903;0,496329891;0,503670109
510380;FIGUEIROPOLIS D'OESTE;1693;1718;3411;0,496335386;0,503664614
354830;SANTO EXPEDITO;1568;1591;3159;0,496359607;0,503640393
310020;ABAETE;11547;11716;23263;0,496367622;0,503632378
412090;QUEDAS DO IGUACU;17228;17479;34707;0,496384015;0,503615985
410105;ANAHY;1377;1397;2774;0,496395097;0,503604903
220213;CAMPO GRANDE DO PIAUI;2972;3015;5987;0,496408886;0,503591114
420675;IBIAM;969;983;1952;0,496413934;0,503586066
270135;CAMPESTRE;3461;3511;6972;0,496414228;0,503585772
240370;FELIPE GUERRA;2983;3026;6009;0,496422034;0,503577966
431475;POCO DAS ANTAS;1045;1060;2105;0,496437055;0,503562945
230580;IPU;20924;21224;42148;0,496441112;0,503558888
310340;ARACUAI;18227;18488;36715;0,496445594;0,503554406
410753;ENTRE RIOS DO OESTE;2309;2342;4651;0,496452376;0,503547624
210637;MARANHAOZINHO;8318;8436;16754;0,496478453;0,503521547
355170;SERTAOZINHO;63764;64668;128432;0,496480628;0,503519372
412855;VERA CRUZ DO OESTE;4165;4224;8389;0,49648349;0,50351651
412840;URAI;5577;5656;11233;0,496483575;0,503516425
421820;TIMBO;22691;23012;45703;0,496488196;0,503511804
355070;SAO SEBASTIAO;45497;46140;91637;0,496491592;0,503508408
240580;JOAO CAMARA;17556;17804;35360;0,496493213;0,503506787
354470;SAGRES;1205;1222;2427;0,496497734;0,503502266
431975;SAO VENDELINO;1136;1152;2288;0,496503497;0,503496503
311310;CARANAIBA;1564;1586;3150;0,496507937;0,503492063
510180;BARRA DO GARCAS;30636;31066;61702;0,49651551;0,50348449
210570;LAGO DA PEDRA;25302;25657;50959;0,496516808;0,503483192
430660;DOM PEDRITO;18978;19244;38222;0,496520329;0,503479671
261600;VENTUROSA;9352;9483;18835;0,496522432;0,503477568
520650;CROMINIA;1717;1741;3458;0,496529786;0,503470214
260470;CORRENTES;9100;9227;18327;0,496535167;0,503464833
430750;ESPUMOSO;7743;7851;15594;0,49653713;0,50346287
291510;ITAGI;6028;6112;12140;0,496540362;0,503459638
316920;TOMBOS;3815;3868;7683;0,496550827;0,503449173
310290;ANTONIO CARLOS;5696;5775;11471;0,496556534;0,503443466
270360;JAPARATINGA;4193;4251;8444;0,496565609;0,503434391
431970;SAO VALENTIM;1599;1621;3220;0,496583851;0,503416149
312310;DORES DE GUANHAES;2552;2587;5139;0,496594668;0,503405332
312430;ESPINOSA;15694;15909;31603;0,496598424;0,503401576
221090;SOCORRO DO PIAUI;2263;2294;4557;0,496598639;0,503401361
313350;ITAPECERICA;10806;10954;21760;0,496599265;0,503400735
251590;SERRARIA;2998;3039;6037;0,496604274;0,503395726
291720;ITUACU;9483;9612;19095;0,496622152;0,503377848
251396;SAO DOMINGOS;1549;1570;3119;0,496633536;0,503366464
291990;MACURURE;3850;3902;7752;0,496646027;0,503353973
421050;MARAVILHA;13143;13320;26463;0,496655708;0,503344292
431350;OSORIO;23251;23564;46815;0,496657054;0,503342946
241420;TIBAU DO SUL;7298;7396;14694;0,496665306;0,503334694
170030;AGUIARNOPOLIS;3501;3548;7049;0,496666194;0,503333806
410850;GENERAL CARNEIRO;6785;6876;13661;0,496669351;0,503330649
520425;CACHOEIRA DOURADA;3972;4025;7997;0,496686257;0,503313743
230290;CAPISTRANO;8856;8974;17830;0,49669097;0,50330903
240340;EQUADOR;3012;3052;6064;0,496701847;0,503298153
411540;MARMELEIRO;7156;7251;14407;0,496702992;0,503297008
230850;MOMBACA;21814;22103;43917;0,496709702;0,503290298
240620;LAGOA D'ANTA;3403;3448;6851;0,496715808;0,503284192
220150;BATALHA;13387;13564;26951;0,496716263;0,503283737
520910;GOIATUBA;17041;17266;34307;0,496720786;0,503279214
292180;MORTUGABA;5992;6071;12063;0,496725524;0,503274476
351780;GUARACAI;4102;4156;8258;0,496730443;0,503269557
411605;MISSAL;5318;5388;10706;0,496730805;0,503269195
411770;PALMEIRA;16943;17166;34109;0,496731068;0,503268932
420620;GRAVATAL;5788;5864;11652;0,496738757;0,503261243
430080;ANTONIO PRADO;6478;6563;13041;0,496741047;0,503258953
411750;PAICANDU;20988;21263;42251;0,496745639;0,503254361
330090;CAMBUCI;7710;7811;15521;0,496746344;0,503253656
230940;NOVO ORIENTE;14275;14462;28737;0,496746355;0,503253645
432146;TIO HUGO;1529;1549;3078;0,496751137;0,503248863
316560;SENADOR CORTES;994;1007;2001;0,496751624;0,503248376
420400;CATANDUVAS;5517;5589;11106;0,496758509;0,503241491
431075;IVORA;921;933;1854;0,496763754;0,503236246
231340;TIANGUA;38306;38805;77111;0,496764405;0,503235595
260560;FLORES;11233;11379;22612;0,496771626;0,503228374
110148;SAO FELIPE D'OESTE;2465;2497;4962;0,496775494;0,503224506
110120;MINISTRO ANDREAZZA;4700;4761;9461;0,496776239;0,503223761
354270;RESTINGA;3856;3906;7762;0,496779181;0,503220819
210350;COLINAS;20589;20854;41443;0,496802838;0,503197162
293200;UAUA;11919;12072;23991;0,496811304;0,503188696
355600;URUPES;6938;7027;13965;0,496813462;0,503186538
431810;SAO FRANCISCO DE ASSIS;8983;9098;18081;0,496819866;0,503180134
410780;FLORAI;2426;2457;4883;0,496825722;0,503174278
430607;CRISTAL DO SUL;1411;1429;2840;0,496830986;0,503169014
355330;TAMBAU;11554;11701;23255;0,496839389;0,503160611
260105;ARACOIABA;10402;10534;20936;0,496847535;0,503152465
220667;MORRO DO CHAPEU DO PIAUI;3391;3434;6825;0,496849817;0,503150183
313835;LEME DO PRADO;2446;2477;4923;0,496851513;0,503148487
315250;POUSO ALEGRE;76662;77631;154293;0,496859871;0,503140129
330450;RIO DAS FLORES;4671;4730;9401;0,496862036;0,503137964
312590;FERROS;4758;4818;9576;0,496867168;0,503132832
160060;SANTANA;62013;62795;124808;0,496867188;0,503132812
291070;EUCLIDES DA CUNHA;30365;30747;61112;0,496874591;0,503125409
292300;NOVA VICOSA;21947;22223;44170;0,496875707;0,503124293
412250;RONCADOR;4694;4753;9447;0,496877316;0,503122684
430597;COXILHA;1357;1374;2731;0,496887587;0,503112413
240350;ESPIRITO SANTO;5199;5264;10463;0,496893816;0,503106184
312730;GALILEIA;3361;3403;6764;0,496895328;0,503104672
313830;LEANDRO FERREIRA;1601;1621;3222;0,496896338;0,503103662
420120;ANTONIO CARLOS;4329;4383;8712;0,496900826;0,503099174
432070;SOBRADINHO;7474;7567;15041;0,49690845;0,50309155
354925;SAO JOAO DE IRACEMA;965;977;1942;0,496910402;0,503089598
320140;CASTELO;18861;19095;37956;0,496917483;0,503082517
431673;SANTA CECILIA DO SUL;810;820;1630;0,496932515;0,503067485
311545;CATUJI;3084;3122;6206;0,496938447;0,503061553
354070;PORTO FERREIRA;28250;28598;56848;0,496939206;0,503060794
280320;ITAPORANGA D'AJUDA;17420;17634;35054;0,496947567;0,503052433
240290;CORONEL JOAO PESSOA;2444;2474;4918;0,49694998;0,50305002
150640;SANTA CRUZ DO ARARI;5216;5280;10496;0,49695122;0,50304878
420870;JACINTO MACHADO;5137;5200;10337;0,496952694;0,503047306
260510;CUSTODIA;18702;18931;37633;0,496957458;0,503042542
351200;COLINA;9244;9357;18601;0,496962529;0,503037471
292350;PALMEIRAS;4534;4589;9123;0,496985641;0,503014359
260720;IPOJUCA;49252;49849;99101;0,496987921;0,503012079
350850;CACAPAVA;47588;48164;95752;0,49699223;0,50300777
260750;ITAIBA;13055;13213;26268;0,496992538;0,503007462
330225;ITATIAIA;16060;16252;32312;0,497028968;0,502971032
352680;LENCOIS PAULISTA;34561;34972;69533;0,497044569;0,502955431
421190;PALHOCA;88813;89866;178679;0,497053375;0,502946625
411120;ITAPEJARA D'OESTE;6074;6146;12220;0,49705401;0,50294599
353050;MOCOCA;34333;34739;69072;0,497061038;0,502938962
316930;TRES CORACOES;40045;40516;80561;0,497076749;0,502923251
411100;ITAMBARACA;3239;3277;6516;0,497084101;0,502915899
210005;ACAILANDIA;56561;57222;113783;0,497095348;0,502904652
292600;REMANSO;20542;20782;41324;0,497096118;0,502903882
316990;UBA;58655;59340;117995;0,497097335;0,502902665
313560;JEQUITAI;3682;3725;7407;0,49709734;0,50290266
355720;CHAVANTES;6173;6245;12418;0,497100982;0,502899018
315130;PIRAUBA;5335;5397;10732;0,497111442;0,502888558
411900;PEROLA D'OESTE;3098;3134;6232;0,497111682;0,502888318
351630;FRANCISCO MORATO;89169;90203;179372;0,497117722;0,502882278
351660;GALIA;3191;3228;6419;0,497117931;0,502882069
316490;SAO SEBASTIAO DO RIO VERDE;1123;1136;2259;0,497122621;0,502877379
430693;ENTRE-IJUIS;4151;4199;8350;0,497125749;0,502874251
355715;ZACARIAS;1384;1400;2784;0,497126437;0,502873563
521290;MARZAGAO;1125;1138;2263;0,497127707;0,502872293
270420;LIMOEIRO DE ANADIA;14369;14535;28904;0,497128425;0,502871575
312610;FORMIGA;33783;34173;67956;0,497130496;0,502869504
353740;PEREIRA BARRETO;12769;12916;25685;0,497138408;0,502861592
251272;PEDRO REGIS;3052;3087;6139;0,497149373;0,502850627
316553;SARZEDO;16928;17122;34050;0,497151248;0,502848752
220870;REDENCAO DO GURGUEIA;4382;4432;8814;0,497163603;0,502836397
520850;GOIANDIRA;2809;2841;5650;0,497168142;0,502831858
241000;PILOES;1939;1961;3900;0,497179487;0,502820513
351140;CERQUEIRA CESAR;10138;10253;20391;0,497180128;0,502819872
230120;ARACOIABA;13225;13375;26600;0,497180451;0,502819549
251330;SANTA HELENA;2910;2943;5853;0,497180933;0,502819067
352880;MARACAI;6995;7074;14069;0,497192409;0,502807591
291730;ITUBERA;14354;14516;28870;0,497194319;0,502805681
170290;AXIXA DO TOCANTINS;4881;4936;9817;0,497198737;0,502801263
251680;TRIUNFO;4710;4763;9473;0,497202576;0,502797424
421690;SAO LOURENCO DO OESTE;12182;12319;24501;0,497204196;0,502795804
412215;RIO BONITO DO IGUACU;6583;6657;13240;0,497205438;0,502794562
431217;MATO QUEIMADO;801;810;1611;0,497206704;0,502793296
210232;BURITICUPU;36592;37003;73595;0,497207691;0,502792309
211020;SANTA RITA;19258;19474;38732;0,497211608;0,502788392
290360;BIRITINGA;7950;8039;15989;0,497216837;0,502783163
260570;FLORESTA;16651;16837;33488;0,497222886;0,502777114
210594;LAGO DOS RODRIGUES;4396;4445;8841;0,49722882;0,50277118
251160;PILOES;3241;3277;6518;0,497238417;0,502761583
230800;MASSAPE;19562;19779;39341;0,497242063;0,502757937
250950;MONTADAS;2887;2919;5806;0,49724423;0,50275577
430513;CERRO BRANCO;2347;2373;4720;0,497245763;0,502754237
210580;LAGO DO JUNCO;5420;5480;10900;0,497247706;0,502752294
431349;NOVO BARREIRO;2081;2104;4185;0,497252091;0,502747909
210190;BEQUIMAO;10600;10717;21317;0,497255711;0,502744289
290050;ERICO CARDOSO;5228;5285;10513;0,497289071;0,502710929
510320;COLIDER;16836;17019;33855;0,497297297;0,502702703
351510;EMBU-GUACU;35011;35391;70402;0,497301213;0,502698787
290390;BOM JESUS DA LAPA;34887;35264;70151;0,497312939;0,502687061
210460;GOVERNADOR EUGENIO BARROS;7312;7391;14703;0,497313473;0,502686527
431130;LAGOA VERMELHA;13801;13950;27751;0,497315412;0,502684588
432195;TRINDADE DO SUL;2875;2906;5781;0,497318803;0,502681197
352000;IGARACU DO TIETE;12344;12477;24821;0,497320817;0,502679183
355700;VOTORANTIM;61902;62566;124468;0,497332648;0,502667352
410302;BOA ESPERANCA DO IGUACU;1212;1225;2437;0,497332786;0,502667214
210540;ITAPECURU MIRIM;34432;34801;69233;0,497335086;0,502664914
350070;AGUDOS;18691;18891;37582;0,497339152;0,502660848
211250;TUTOIA;29805;30122;59927;0,497355115;0,502644885
292290;NOVA SOURE;13452;13595;27047;0,497356454;0,502643546
310750;BOM JARDIM DE MINAS;3205;3239;6444;0,497361887;0,502638113
210370;CURURUPU;16194;16365;32559;0,497373998;0,502626002
230340;CARNAUBAL;8835;8928;17763;0,497382199;0,502617801
354240;REGENTE FEIJO;10208;10315;20523;0,497393169;0,502606831
260415;CASINHAS;7160;7235;14395;0,497394929;0,502605071
210160;BARRA DO CORDA;44216;44679;88895;0,497395804;0,502604196
220865;QUEIMADA NOVA;4497;4544;9041;0,49740073;0,50259927
230125;ARARENDA;5463;5520;10983;0,497405081;0,502594919
310740;BOM DESPACHO;25585;25851;51436;0,497414262;0,502585738
500215;BODOQUENA;3881;3921;7802;0,497436555;0,502563445
351150;CERQUILHO;25186;25445;50631;0,497442278;0,502557722
410490;CASTRO;35879;36246;72125;0,497455806;0,502544194
220385;FLORESTA DO PIAUI;1274;1287;2561;0,497461929;0,502538071
350920;CAJAMAR;39317;39717;79034;0,497469444;0,502530556
355350;TAPIRAI;3843;3882;7725;0,497475728;0,502524272
355385;TAQUARIVAI;2969;2999;5968;0,497486595;0,502513405
354600;SANTA BRANCA;7425;7500;14925;0,497487437;0,502512563
510515;JUINA;20492;20698;41190;0,497499393;0,502500607
352980;MINEIROS DO TIETE;6479;6544;13023;0,497504415;0,502495585
260740;ITACURUBA;2494;2519;5013;0,497506483;0,502493517
290420;BOTUPORA;5000;5050;10050;0,497512438;0,502487562
312260;DOM JOAQUIM;2207;2229;4436;0,497520289;0,502479711
353290;NOVA EUROPA;5731;5788;11519;0,497525827;0,502474173
291185;HELIOPOLIS;6441;6505;12946;0,497528194;0,502471806
351350;CUBATAO;65933;66588;132521;0,497528694;0,502471306
260250;BREJINHO;3726;3763;7489;0,49752971;0,50247029
521220;JUSSARA;9088;9178;18266;0,497536406;0,502463594
240360;EXTREMOZ;14569;14713;29282;0,497541152;0,502458848
351960;IBITINGA;30426;30724;61150;0,497563369;0,502436631
261280;SANTA TEREZINHA;5928;5986;11914;0,497565889;0,502434111
431275;NOVA ALVORADA;1840;1858;3698;0,497566252;0,502433748
431301;NOVA CANDELARIA;1332;1345;2677;0,497571909;0,502428091
315550;RIO PARANAIBA;6148;6208;12356;0,49757203;0,50242797
270140;CAMPO ALEGRE;28858;29139;57997;0,497577461;0,502422539
260270;BUENOS AIRES;6580;6644;13224;0,497580157;0,502419843
230700;JAGUARUANA;16898;17062;33960;0,497585395;0,502414605
310420;ARCOS;20231;20427;40658;0,49758965;0,50241035
355360;TAPIRATIBA;6439;6501;12940;0,497604328;0,502395672
431175;MANOEL VIANA;3640;3675;7315;0,497607656;0,502392344
171610;PARAISO DO TOCANTINS;26135;26386;52521;0,49761048;0,50238952
230725;JIJOCA DE JERICOACOARA;10127;10224;20351;0,497616825;0,502383175
231410;VICOSA DO CEARA;30811;31105;61916;0,497625816;0,502374184
172020;SAO MIGUEL DO TOCANTINS;6193;6252;12445;0,49762957;0,50237043
320330;MANTENOPOLIS;7790;7863;15653;0,497668179;0,502331821
500060;AMAMBAI;20030;20217;40247;0,497676845;0,502323155
220672;NAZARIA;4296;4336;8632;0,49768304;0,50231696
316447;SAO SEBASTIAO DO ANTA;3333;3364;6697;0,497685531;0,502314469
220320;CURIMATA;5704;5757;11461;0,497687811;0,502312189
412320;SANTA CECILIA DO PAVAO;1619;1634;3253;0,497694436;0,502305564
280580;RIACHAO DO DANTAS;9861;9952;19813;0,497703528;0,502296472
230240;BOA VIAGEM;27215;27465;54680;0,497713972;0,502286028
353360;NUPORANGA;3744;3778;7522;0,497739963;0,502260037
320335;MARILANDIA;6516;6575;13091;0,497746543;0,502253457
251278;RIACHO DE SANTO ANTONIO;995;1004;1999;0,497748874;0,502251126
353820;PINHALZINHO;7747;7817;15564;0,497751221;0,502248779
431270;NONOAI;5761;5813;11574;0,497753586;0,502246414
150060;ALTAMIRA;58397;58923;117320;0,497758268;0,502241732
420360;CAMPOS NOVOS;18348;18513;36861;0,497761862;0,502238138
210880;PIRAPEMAS;9365;9449;18814;0,49776762;0,50223238
250640;GURINHEM;7031;7094;14125;0,497769912;0,502230088
317170;VIRGINIA;4307;4345;8652;0,497803976;0,502196024
353540;PANORAMA;7937;8007;15944;0,497804817;0,502195183
314290;MONTE AZUL;10227;10317;20544;0,497809579;0,502190421
291150;GONGOGI;3411;3441;6852;0,497810858;0,502189142
430355;CAMARGO;1369;1381;2750;0,497818182;0,502181818
241150;SANTO ANTONIO;12158;12264;24422;0,497829826;0,502170174
312790;GRUPIARA;690;696;1386;0,497835498;0,502164502
420917;JUPIA;1037;1046;2083;0,497839654;0,502160346
420470;CUNHA PORA;5551;5599;11150;0,497847534;0,502152466
220530;JERUMENHA;2212;2231;4443;0,497861805;0,502138195
421500;RIO NEGRINHO;21251;21433;42684;0,497868054;0,502131946
320280;ITAPEMIRIM;17404;17553;34957;0,49786881;0,50213119
310860;BRASILIA DE MINAS;16161;16299;32460;0,497874307;0,502125693
421570;SANTO AMARO DA IMPERATRIZ;11903;12004;23907;0,497887648;0,502112352
260730;IPUBI;15691;15824;31515;0,497889894;0,502110106
170765;FIGUEIROPOLIS;2600;2622;5222;0,497893527;0,502106473
412830;UNIFLOR;1306;1317;2623;0,497903164;0,502096836
521440;NAZARIO;4668;4707;9375;0,49792;0,50208
353480;OURO VERDE;4320;4356;8676;0,497925311;0,502074689
250780;JUNCO DO SERIDO;3604;3634;7238;0,497927604;0,502072396
421569;SANTIAGO DO SUL;603;608;1211;0,49793559;0,50206441
230200;BARRO;11370;11464;22834;0,497941666;0,502058334
150812;ULIANOPOLIS;31015;31271;62286;0,497944964;0,502055036
240740;MARTINS;4377;4413;8790;0,497952218;0,502047782
250500;CUBATI;3917;3949;7866;0,497965929;0,502034071
291835;JOAO DOURADO;12751;12855;25606;0,497969226;0,502030774
250077;APARECIDA;4224;4258;8482;0,497995756;0,502004244
292937;SAO JOSE DO JACUIPE;5252;5294;10546;0,498008724;0,501991276
250470;CONGO;2384;2403;4787;0,498015459;0,501984541
411630;MUNHOZ DE MELO;2009;2025;4034;0,498016857;0,501983143
312130;DESCOBERTO;2512;2532;5044;0,498017446;0,501982554
292465;PINTADAS;5156;5197;10353;0,498019898;0,501980102
221005;SAO JOSE DO DIVINO;2670;2691;5361;0,49804141;0,50195859
500190;BATAGUASSU;11764;11856;23620;0,498052498;0,501947502
330022;AREAL;6357;6406;12763;0,498080389;0,501919611
412280;SALGADO FILHO;1688;1701;3389;0,49808203;0,50191797
290600;CAMPO FORMOSO;35740;36014;71754;0,498090699;0,501909301
230445;FORTIM;8356;8420;16776;0,498092513;0,501907487
510410;GUARANTA DO NORTE;18150;18289;36439;0,498092703;0,501907297
313420;ITUIUTABA;52708;53110;105818;0,498100512;0,501899488
350940;CAJURU;13256;13357;26613;0,498102431;0,501897569
293110;TANQUINHO;3953;3983;7936;0,498109879;0,501890121
110090;CASTANHEIRAS;1456;1467;2923;0,498118372;0,501881628
330615;VARRE-SAI;5583;5625;11208;0,498126338;0,501873662
120017;CAPIXABA;6117;6163;12280;0,498127036;0,501872964
411585;MERCEDES;2798;2819;5617;0,498130675;0,501869325
421280;BALNEARIO PICARRAS;12147;12238;24385;0,498134099;0,501865901
241355;SERRINHA DOS PINTOS;2407;2425;4832;0,498137417;0,501862583
290685;CAPELA DO ALTO ALEGRE;5777;5820;11597;0,498146072;0,501853928
250135;ASSUNCAO;2026;2041;4067;0,498155889;0,501844111
110130;MIRANTE DA SERRA;5326;5365;10691;0,498176036;0,501823964
220290;CORRENTE;13337;13434;26771;0,498188338;0,501811662
261247;SANTA CRUZ DA BAIXA VERDE;6331;6377;12708;0,498190116;0,501809884
320220;FUNDAO;11149;11230;22379;0,498190268;0,501809732
500110;AQUIDAUANA;24005;24179;48184;0,498194421;0,501805579
353520;PALMEIRA D'OESTE;4570;4603;9173;0,498201243;0,501798757
150110;BAGRE;15926;16041;31967;0,49820127;0,50179873
250460;CONDE;12625;12716;25341;0,498204491;0,501795509
420245;BOMBINHAS;10407;10482;20889;0,498204797;0,501795203
410590;COLORADO;12092;12179;24271;0,498207738;0,501792262
270500;MATA GRANDE;12555;12645;25200;0,498214286;0,501785714
292680;RIO DO ANTONIO;7733;7788;15521;0,498228207;0,501771793
430070;ANTA GORDA;2960;2981;5941;0,498232621;0,501767379
316095;SAO DOMINGOS DAS DORES;2826;2846;5672;0,498236953;0,501763047
312930;IAPU;5523;5562;11085;0,498240866;0,501759134
170100;ANANAS;4701;4734;9435;0,498251192;0,501748808
310640;BELO VALE;3848;3875;7723;0,498251975;0,501748025
210080;ANAPURUS;7999;8055;16054;0,498255886;0,501744114
353150;MONTE AZUL PAULISTA;9431;9497;18928;0,498256551;0,501743449
412750;TIBAGI;10308;10380;20688;0,498259861;0,501740139
431600;ROLANTE;10758;10833;21591;0,498263165;0,501736835
412665;SULINA;1435;1445;2880;0,498263889;0,501736111
270450;MARAGOGI;16618;16733;33351;0,498275914;0,501724086
292690;RIO DO PIRES;5816;5856;11672;0,498286498;0,501713502
251394;SAO DOMINGOS DO CARIRI;1318;1327;2645;0,498298677;0,501701323
231100;PORANGA;6158;6200;12358;0,498300696;0,501699304
241400;TANGARA;7977;8031;16008;0,498313343;0,501686657
316010;SANTO ANTONIO DO GRAMA;1924;1937;3861;0,498316498;0,501683502
280010;AMPARO DE SAO FRANCISCO;1189;1197;2386;0,498323554;0,501676446
421540;SALTO VELOSO;2388;2404;4792;0,498330551;0,501669449
410345;CAFELANDIA;9361;9422;18783;0,498376191;0,501623809
230640;ITAPIPOCA;65632;66055;131687;0,498393919;0,501606081
430780;ESTRELA;17279;17390;34669;0,498399146;0,501600854
241220;SAO JOSE DE MIPIBU;22212;22354;44566;0,498406857;0,501593143
351310;CRAVINHOS;17872;17986;35858;0,498410397;0,501589603
241230;SAO JOSE DO CAMPESTRE;6430;6471;12901;0,498410976;0,501589024
430100;ARROIO DO MEIO;10527;10594;21121;0,498413901;0,501586099
313100;INHAUMA;3166;3186;6352;0,498425693;0,501574307
291710;ITORORO;10165;10229;20394;0,498430911;0,501569089
280150;CARMOPOLIS;8589;8643;17232;0,498433148;0,501566852
412710;TELEMACO BORBA;40168;40420;80588;0,498436492;0,501563508
421620;SAO FRANCISCO DO SUL;27290;27461;54751;0,498438385;0,501561615
261560;TRINDADE;15503;15600;31103;0,498440665;0,501559335
351230;CONCHAS;9041;9097;18138;0,49845628;0,50154372
110018;PIMENTA BUENO;18492;18606;37098;0,498463529;0,501536471
280200;DIVINA PASTORA;2637;2653;5290;0,498487713;0,501512287
110060;CACAULANDIA;3144;3163;6307;0,498493737;0,501506263
313900;MACHADO;21277;21405;42682;0,498500539;0,501499461
521890;RUBIATABA;9976;10036;20012;0,498500899;0,501499101
350870;CACONDE;9487;9544;19031;0,498502443;0,501497557
520090;AMORINOPOLIS;1501;1510;3011;0,49850548;0,50149452
231190;SABOEIRO;7855;7902;15757;0,498508599;0,501491401
410180;ARAUCARIA;74041;74481;148522;0,498518738;0,501481262
430320;CACIQUE DOBLE;2534;2549;5083;0,498524493;0,501475507
412000;PORECATU;6275;6312;12587;0,49853023;0,50146977
354160;PROMISSAO;20545;20666;41211;0,498531945;0,501468055
421830;TRES BARRAS;9699;9756;19455;0,498535081;0,501464919
430810;FELIZ;6844;6884;13728;0,498543124;0,501456876
230530;IBIAPINA;12546;12619;25165;0,498549573;0,501450427
352550;JOANOPOLIS;6707;6746;13453;0,498550509;0,501449491
521710;PIRACANJUBA;12236;12307;24543;0,498553559;0,501446441
240450;GUAMARE;8107;8154;16261;0,498554824;0,501445176
270350;JACUIPE;3486;3506;6992;0,498569794;0,501430206
317150;MATHIAS LOBATO;1574;1583;3157;0,498574596;0,501425404
312735;GLAUCILANDIA;1584;1593;3177;0,498583569;0,501416431
355640;VARGEM GRANDE DO SUL;21623;21745;43368;0,498593433;0,501406567
421780;TAIO;9262;9314;18576;0,498600345;0,501399655
352520;JARINU;15543;15630;31173;0,498604562;0,501395438
250790;JURIPIRANGA;5400;5430;10830;0,498614958;0,501385042
280130;CAPELA;17356;17452;34808;0,498621007;0,501378993
431980;SAO VICENTE DO SUL;4359;4383;8742;0,498627316;0,501372684
421340;PONTE SERRADA;5821;5853;11674;0,498629433;0,501370567
420280;BRACO DO NORTE;17101;17193;34294;0,498658657;0,501341343
410820;FORMOSA DO OESTE;3164;3181;6345;0,498660362;0,501339638
431971;SAO VALENTIM DO SUL;1121;1127;2248;0,49866548;0,50133452
250415;CASSERENGUE;3755;3775;7530;0,498671979;0,501328021
431262;MULITERNO;948;953;1901;0,498684903;0,501315097
220177;BOA HORA;3415;3433;6848;0,498685748;0,501314252
270740;PORTO DE PEDRAS;3799;3819;7618;0,49868732;0,50131268
521900;SANCLERLANDIA;3805;3825;7630;0,498689384;0,501310616
411510;MARILUZ;5150;5177;10327;0,498692747;0,501307253
412575;SAO PEDRO DO IGUACU;2865;2880;5745;0,498694517;0,501305483
315580;RIO POMBA;8980;9027;18007;0,498694952;0,501305048
510704;PRIMAVERA DO LESTE;31855;32021;63876;0,498700607;0,501299393
430047;ALMIRANTE TAMANDARE DO SUL;965;970;1935;0,49870801;0,50129199
210840;PERI MIRIM;7167;7204;14371;0,498712685;0,501287315
431660;SANANDUVA;8170;8212;16382;0,498718105;0,501281895
290205;ARACAS;6103;6134;12237;0,49873335;0,50126665
260090;AMARAJI;11426;11484;22910;0,498734177;0,501265823
522045;SENADOR CANEDO;60570;60877;121447;0,498736074;0,501263926
292390;PAU BRASIL;4763;4787;9550;0,498743455;0,501256545
211100;SAO JOAO BATISTA;10342;10394;20736;0,498746142;0,501253858
355365;TAQUARAL;1404;1411;2815;0,498756661;0,501243339
250240;BONITO DE SANTA FE;6048;6078;12126;0,498762989;0,501237011
431790;SANTO CRISTO;7071;7106;14177;0,498765606;0,501234394
170560;CONCEICAO DO TOCANTINS;2030;2040;4070;0,498771499;0,501228501
210542;ITINGA DO MARANHAO;13035;13099;26134;0,498775541;0,501224459
411410;MANDAGUACU;11658;11715;23373;0,498780644;0,501219356
290620;CANARANA;13202;13266;26468;0,498790993;0,501209007
410900;GUAPIRAMA;1879;1888;3767;0,498805415;0,501194585
230040;AIUABA;8771;8813;17584;0,498805732;0,501194268
290280;BARRA DA ESTIVA;10075;10123;20198;0,498811764;0,501188236
312870;GUAXUPE;26055;26179;52234;0,498813034;0,501186966
410720;DOIS VIZINHOS;20663;20761;41424;0,498817111;0,501182889
421550;SANTA CECILIA;8482;8522;17004;0,498823806;0,501176194
430190;BARRA DO RIBEIRO;6793;6825;13618;0,498825084;0,501174916
220490;ISAIAS COELHO;4281;4301;8582;0,49883477;0,50116523
314710;PARA DE MINAS;47697;47919;95616;0,498839106;0,501160894
240670;LAJES;5692;5718;11410;0,498860649;0,501139351
291980;MACAUBAS;25183;25298;50481;0,498860958;0,501139042
210465;GOVERNADOR NEWTON BELLO;5049;5072;10121;0,498863749;0,501136251
240180;BREJINHO;6422;6451;12873;0,498873611;0,501126389
315520;RIO ESPERA;2660;2672;5332;0,498874719;0,501125281
410160;ARAPOTI;14208;14272;28480;0,498876404;0,501123596
351770;GUARA;10673;10721;21394;0,49887819;0,50112181
231135;QUIXELO;8040;8076;16116;0,498883098;0,501116902
210087;ARAGUANA;7820;7855;15675;0,498883573;0,501116427
220207;CAJAZEIRAS DO PIAUI;1789;1797;3586;0,498884551;0,501115449
240170;BOM JESUS;5150;5173;10323;0,498885983;0,501114017
290135;ANDORINHA;7192;7224;14416;0,498890122;0,501109878
421085;MIRIM DOCE;1126;1131;2257;0,498892335;0,501107665
220525;JARDIM DO MULATO;2256;2266;4522;0,498894295;0,501105705
310840;BOTELHOS;7447;7480;14927;0,49889462;0,50110538
313770;LAJINHA;9935;9979;19914;0,49889525;0,50110475
352860;MANDURI;4975;4997;9972;0,498896911;0,501103089
420180;ATALANTA;1586;1593;3179;0,498899025;0,501100975
430515;CERRO GRANDE;1138;1143;2281;0,498903989;0,501096011
317200;VISCONDE DO RIO BRANCO;21628;21723;43351;0,498904293;0,501095707
421250;PENHA;16974;17048;34022;0,498912468;0,501087532
211065;SAO DOMINGOS DO AZEITAO;3716;3732;7448;0,498925886;0,501074114
353340;NOVA ODESSA;30792;30924;61716;0,498930585;0,501069415
520485;CAMPO LIMPO DE GOIAS;4035;4052;8087;0,49894893;0,50105107
250440;CONCEICAO;9495;9535;19030;0,498949028;0,501050972
310665;BERIZAL;2391;2401;4792;0,498956594;0,501043406
220775;PASSAGEM FRANCA DO PIAUI;2161;2170;4331;0,498960979;0,501039021
411360;LOBATO;2420;2430;4850;0,498969072;0,501030928
355560;UCHOA;5085;5106;10191;0,498969679;0,501030321
410975;IBEMA;3187;3200;6387;0,498982308;0,501017692
313490;JACUTINGA;13242;13296;26538;0,498982591;0,501017409
412400;SANTANA DO ITARARE;2453;2463;4916;0,498982913;0,501017087
316510;SAO TOMAS DE AQUINO;3483;3497;6980;0,498997135;0,501002865
316555;SETUBINHA;6234;6259;12493;0,49899944;0,50100056
312080;CRUZILIA;7749;7780;15529;0,499001867;0,500998133
412230;RIO NEGRO;17288;17357;34645;0,499004185;0,500995815
290910;CORIBE;7040;7068;14108;0,499007655;0,500992345
420950;LAURENTINO;3570;3584;7154;0,499021526;0,500978474
432200;TRIUNFO;15050;15109;30159;0,499021851;0,500978149
521770;PONTALINA;8932;8967;17899;0,499022292;0,500977708
314320;MONTE SANTO DE MINAS;10731;10773;21504;0,499023438;0,500976563
351810;GUARANTA;3336;3349;6685;0,499027674;0,500972326
411760;PALMAS;26201;26302;52503;0,49903815;0,50096185
293260;URANDI;8320;8352;16672;0,499040307;0,500959693
410840;FRANCISCO BELTRAO;46565;46743;93308;0,49904617;0,50095383
260650;IATI;9624;9660;19284;0,499066584;0,500933416
411680;NOVA CANTU;2409;2418;4827;0,499067744;0,500932256
250140;BAIA DA TRAICAO;4590;4607;9197;0,499075786;0,500924214
292080;MARCIONILIO SOUZA;5169;5188;10357;0,499082746;0,500917254
353120;MONTE ALEGRE DO SUL;4083;4098;8181;0,499083242;0,500916758
280140;CARIRA;11176;11217;22393;0,499084535;0,500915465
430673;DOUTOR MAURICIO CARDOSO;2186;2194;4380;0,499086758;0,500913242
290220;ARAMARI;5749;5770;11519;0,499088463;0,500911537
230770;MARANGUAPE;65720;65957;131677;0,499100071;0,500899929
355530;TURMALINA;832;835;1667;0,49910018;0,50089982
351020;CAPAO BONITO;23507;23591;47098;0,499108242;0,500891758
290560;CAMACAN;15983;16040;32023;0,499110015;0,500889985
430805;FAXINALZINHO;1126;1130;2256;0,499113475;0,500886525
150442;MARITUBA;67786;68026;135812;0,499116426;0,500883574
355650;VARZEA PAULISTA;62025;62244;124269;0,499118847;0,500881153
432232;TURUCU;1701;1707;3408;0,499119718;0,500880282
355590;URU;570;572;1142;0,499124343;0,500875657
312190;DIVINESIA;1712;1718;3430;0,499125364;0,500874636
261190;RIO FORMOSO;11839;11880;23719;0,499135714;0,500864286
261500;TAQUARITINGA DO NORTE;14711;14761;29472;0,499151737;0,500848263
430370;CAMPINA DAS MISSOES;2658;2667;5325;0,49915493;0,50084507
353710;PEDREIRA;24455;24537;48992;0,499163129;0,500836871
431170;MACHADINHO;2701;2710;5411;0,499168361;0,500831639
292200;MUCURI;21329;21400;42729;0,499169183;0,500830817
313040;IJACI;3328;3339;6667;0,499175041;0,500824959
292170;MORRO DO CHAPEU;17704;17762;35466;0,499182315;0,500817685
420545;FORQUILHINHA;13788;13833;27621;0,499185402;0,500814598
521295;MATRINCHA;2157;2164;4321;0,499190002;0,500809998
421130;NAVEGANTES;42798;42936;85734;0,499195185;0,500804815
352270;ITAPOLIS;21733;21803;43536;0,499196068;0,500803932
354410;RIO GRANDE DA SERRA;25963;26046;52009;0,499202061;0,500797939
430468;CAPELA DE SANTANA;6082;6101;12183;0,499220225;0,500779775
251190;PITIMBU;9724;9754;19478;0,4992299;0,5007701
420210;BARRA VELHA;15246;15293;30539;0,499230492;0,500769508
320300;IUNA;14686;14731;29417;0,499235136;0,500764864
320506;VENDA NOVA DO IMIGRANTE;13082;13122;26204;0,499236758;0,500763242
260780;ITAQUITINGA;8515;8541;17056;0,499237805;0,500762195
421400;PRESIDENTE GETULIO;8973;9000;17973;0,499248873;0,500751127
293230;UBATA;13720;13761;27481;0,49925403;0,50074597
432090;TAPEJARA;12468;12505;24973;0,4992592;0,5007408
500330;COXIM;16749;16798;33547;0,499269681;0,500730319
312300;DORES DE CAMPOS;5138;5153;10291;0,499271208;0,500728792
420515;DOUTOR PEDRINHO;2079;2085;4164;0,499279539;0,500720461
410760;FAXINAL;8677;8702;17379;0,499280741;0,500719259
293315;VARZEA NOVA;6269;6287;12556;0,499283211;0,500716789
352050;INDAIATUBA;130159;130531;260690;0,499286509;0,500713491
110002;ARIQUEMES;55496;55652;111148;0,499298233;0,500701767
210640;MATA ROMA;8549;8573;17122;0,499299147;0,500700853
291540;ITAJU DO COLONIA;3253;3262;6515;0,499309286;0,500690714
240220;CANGUARETAMA;17383;17431;34814;0,499310622;0,500689378
220342;DOMINGOS MOURAO;2173;2179;4352;0,499310662;0,500689338
291970;MACARANI;9515;9541;19056;0,4993178;0,5006822
352840;MAIRINQUE;23829;23894;47723;0,499318987;0,500681013
231020;PARACURU;17739;17787;35526;0,499324438;0,500675562
250160;BARRA DE SANTA ROSA;7793;7814;15607;0,499327225;0,500672775
312170;DIOGO DE VASCONCELOS;1887;1892;3779;0,499338449;0,500661551
250770;JUAZEIRINHO;9199;9223;18422;0,499348605;0,500651395
260380;CAPOEIRAS;10011;10037;20048;0,499351556;0,500648444
420010;ABELARDO LUZ;8996;9019;18015;0,499361643;0,500638357
211210;TIMBIRAS;14602;14639;29241;0,499367327;0,500632673
314530;NOVO CRUZEIRO;15650;15689;31339;0,499377772;0,500622228
311390;CARMO DA CACHOEIRA;6089;6104;12193;0,499384893;0,500615107
411325;LARANJAL;2856;2863;5719;0,499388005;0,500611995
314700;PARACATU;47212;47327;94539;0,499391785;0,500608215
521225;LAGOA SANTA;825;827;1652;0,499394673;0,500605327
291950;LIVRAMENTO DE NOSSA SENHORA;23158;23214;46372;0,499396187;0,500603813
170950;GURUPI;44161;44267;88428;0,499400642;0,500599358
260430;CEDRO;5979;5993;11972;0,499415302;0,500584698
316556;SEM-PEIXE;1288;1291;2579;0,499418379;0,500581621
314860;PECANHA;8757;8777;17534;0,499429679;0,500570321
510645;PLANALTO DA SERRA;1317;1320;2637;0,499431172;0,500568828
220240;CAPITAO DE CAMPOS;5729;5742;11471;0,499433354;0,500566646
352330;ITARIRI;8867;8887;17754;0,499436747;0,500563253
260980;OROCO;7646;7663;15309;0,499444771;0,500555229
220194;BOQUEIRAO DO PIAUI;3218;3225;6443;0,499456775;0,500543225
412880;XAMBRE;2789;2795;5584;0,499462751;0,500537249
110149;SAO FRANCISCO DO GUAPORE;10533;10555;21088;0,499478376;0,500521624
230400;COREAU;11658;11682;23340;0,499485861;0,500514139
411310;KALORE;1996;2000;3996;0,499499499;0,500500501
251030;NOVA PALMEIRA;2503;2508;5011;0,499501098;0,500498902
250720;ITATUBA;5529;5540;11069;0,499503117;0,500496883
421760;SIDEROPOLIS;7081;7095;14176;0,499506208;0,500493792
211090;SAO FRANCISCO DO MARANHAO;6107;6119;12226;0,499509243;0,500490757
521390;MOSSAMEDES;2058;2062;4120;0,499514563;0,500485437
240210;CAMPO REDONDO;5676;5687;11363;0,499515973;0,500484027
230890;MORRINHOS;11404;11426;22830;0,499518178;0,500481822
220559;LAGOA DO SITIO;2607;2612;5219;0,499520981;0,500479019
170240;ARRAIAS;5246;5256;10502;0,4995239;0,5004761
412080;QUATRO BARRAS;12115;12138;24253;0,499525832;0,500474168
315150;PIUMHI;17552;17585;35137;0,49953041;0,50046959
312180;DIONISIO;3743;3750;7493;0,499532897;0,500467103
313880;LUZ;9140;9157;18297;0,499535443;0,500464557
240610;JUCURUTU;9159;9176;18335;0,499536406;0,500463594
520800;FORMOSA;62796;62909;125705;0,499550535;0,500449465
292700;RIO REAL;20586;20623;41209;0,499551069;0,500448931
420320;CAMBORIU;43551;43628;87179;0,49955838;0,50044162
352030;IGUAPE;15545;15572;31117;0,499566154;0,500433846
310730;BOCAIUVA;25239;25282;50521;0,499574434;0,500425566
231220;SANTA QUITERIA;21841;21878;43719;0,499576843;0,500423157
290670;CANDIDO SALES;12450;12471;24921;0,499578669;0,500421331
420720;IMARUI;4878;4886;9764;0,499590332;0,500409668
320305;JAGUARE;15782;15807;31589;0,499604293;0,500395707
313010;IGARAPE;22263;22298;44561;0,49960728;0,50039272
251450;SAO JOSE DE PIRANHAS;10195;10211;20406;0,499607958;0,500392042
293305;VARZEA DA ROCA;7062;7073;14135;0,499610895;0,500389105
310280;ANDRELANDIA;6090;6099;12189;0,499630815;0,500369185
270580;OLHO D'AGUA DO CASADO;4750;4757;9507;0,49963185;0,50036815
430632;DERRUBADAS;1358;1360;2718;0,499632082;0,500367918
311420;CARMO DO CAJURU;11442;11458;22900;0,499650655;0,500349345
313540;JECEABA;2396;2399;4795;0,499687174;0,500312826
411290;JUNDIAI DO SUL;1623;1625;3248;0,499692118;0,500307882
230495;GUAIUBA;13246;13262;26508;0,499698204;0,500301796
320160;CONCEICAO DA BARRA;15730;15749;31479;0,499698212;0,500301788
420410;CAXAMBU DO SUL;1730;1732;3462;0,49971115;0,50028885
311280;CAPITOLIO;4344;4349;8693;0,499712412;0,500287588
270680;PIACABUCU;8929;8939;17868;0,49972017;0,50027983
311470;CARVALHOPOLIS;1806;1808;3614;0,499723298;0,500276702
420960;LAURO MULLER;7686;7694;15380;0,499739922;0,500260078
311400;CARMO DA MATA;5770;5776;11546;0,49974017;0,50025983
430010;AGUDO;8168;8176;16344;0,499755262;0,500244738
351690;GENERAL SALGADO;5425;5430;10855;0,499769691;0,500230309
150655;SANTA LUZIA DO PARA;9915;9924;19839;0,499773174;0,500226826
355210;SOCORRO;20836;20854;41690;0,499784121;0,500215879
353380;OLEO;1223;1224;2447;0,499795668;0,500204332
412420;SANTO ANTONIO DO CAIUA;1305;1306;2611;0,499808502;0,500191498
310540;BARAO DE COCAIS;16610;16622;33232;0,499819451;0,500180549
430030;ALECRIM;2854;2856;5710;0,499824869;0,500175131
410340;CAFEARA;1486;1487;2973;0,49983182;0,50016818
330115;CARDOSO MOREIRA;6407;6411;12818;0,499843969;0,500156031
410100;AMPERE;9730;9736;19466;0,499845885;0,500154115
500570;NAVIRAI;28234;28250;56484;0,499858367;0,500141633
420160;ARROIO TRINTA;1773;1774;3547;0,499859036;0,500140964
352040;ILHABELA;18092;18102;36194;0,499861856;0,500138144
420670;HERVAL D'OESTE;11407;11413;22820;0,499868536;0,500131464
431205;MARQUES DE SOUZA;1990;1991;3981;0,499874403;0,500125597
353320;NOVA INDEPENDENCIA;2067;2068;4135;0,499879081;0,500120919
310870;BRAS PIRES;2127;2128;4255;0,499882491;0,500117509
411190;JAGUAPITA;6929;6932;13861;0,499891783;0,500108217
312940;IBERTIOGA;2499;2500;4999;0,49989998;0,50010002
351460;DUMONT;5086;5088;10174;0,49990171;0,50009829
291830;JITAUNA;5234;5236;10470;0,499904489;0,500095511
250270;BORBOREMA;2655;2656;5311;0,499905856;0,500094144
350300;ARAMINA;2844;2845;5689;0,499912111;0,500087889
292360;PARAMIRIM;10887;10890;21777;0,49993112;0,50006888
150550;PARAGOMINAS;57912;57926;115838;0,499939571;0,500060429
320210;ECOPORANGA;11373;11375;22748;0,49995604;0,50004396
312490;EUGENOPOLIS;5691;5692;11383;0,499956075;0,500043925
312410;ESMERALDAS;36253;36259;72512;0,499958628;0,500041372
240990;PENDENCIAS;7705;7706;15411;0,499967556;0,500032444
261245;SANTA CRUZ;7856;7857;15713;0,499968179;0,500031821
354680;SANTA ISABEL;29263;29266;58529;0,499974372;0,500025628
290500;CACULE;11703;11704;23407;0,499978639;0,500021361
320470;SAO GABRIEL DA PALHA;19542;19543;39085;0,499987207;0,500012793
230220;BEBERIBE;27157;27158;54315;0,499990794;0,500009206
210135;BACURITUBA;2848;2848;5696;0,5;0,5
251020;NOVA OLINDA;2946;2946;5892;0,5;0,5
316120;SAO FRANCISCO DE PAULA;3256;3256;6512;0,5;0,5
320495;SAO ROQUE DO CANAA;6301;6301;12602;0,5;0,5
410010;ABATIA;3680;3680;7360;0,5;0,5
410330;BORRAZOPOLIS;3145;3145;6290;0,5;0,5
410800;FLORESTOPOLIS;5180;5180;10360;0,5;0,5
412535;SAO JORGE DO PATROCINIO;2766;2766;5532;0,5;0,5
431575;RIOZINHO;2349;2349;4698;0,5;0,5
432375;VITORIA DAS MISSOES;1526;1526;3052;0,5;0,5
310400;ARAXA;54202;54201;108403;0,500004612;0,499995388
350100;ALTINOPOLIS;8111;8110;16221;0,500030824;0,499969176
431060;ITAQUI;18683;18680;37363;0,500040147;0,499959853
412100;QUERENCIA DO NORTE;6129;6128;12257;0,500040793;0,499959207
500230;BRASILANDIA;5918;5917;11835;0,500042248;0,499957752
211070;SAO DOMINGOS DO MARANHAO;17197;17194;34391;0,500043616;0,499956384
261430;MOREILANDIA;5635;5634;11269;0,50004437;0,49995563
520390;BURITI ALEGRE;4758;4757;9515;0,500052549;0,499947451
280430;MURIBECA;3827;3826;7653;0,500065334;0,499934666
310510;BAMBUI;11984;11980;23964;0,500083459;0,499916541
315140;PITANGUI;14219;14214;28433;0,500087926;0,499912074
231150;QUIXERE;11218;11214;22432;0,500089158;0,499910842
250610;FAGUNDES;5591;5589;11180;0,500089445;0,499910555
410060;ALTO PARANA;7474;7471;14945;0,500100368;0,499899632
280440;NEOPOLIS;9346;9342;18688;0,500107021;0,499892979
330095;COMENDADOR LEVY GASPARIAN;4296;4294;8590;0,500116414;0,499883586
241105;TIBAU;2087;2086;4173;0,500119818;0,499880182
330110;CANTAGALO;10084;10079;20163;0,500123989;0,499876011
313090;INHAPIM;12013;12007;24020;0,500124896;0,499875104
120045;SENADOR GUIOMARD;11726;11720;23446;0,500127954;0,499872046
411940;PIRAI DO SUL;12893;12886;25779;0,500135769;0,499864231
354530;SALTO DE PIRAPORA;23150;23135;46285;0,50016204;0,49983796
411280;JOAQUIM TAVORA;6056;6052;12108;0,50016518;0,49983482
260920;MARAIAL;5551;5547;11098;0,500180213;0,499819787
320060;ARACRUZ;52490;52452;104942;0,500181052;0,499818948
210545;JATOBA;5234;5230;10464;0,500191131;0,499808869
320190;DOMINGOS MARTINS;17067;17053;34120;0,500205158;0,499794842
520280;AVELINOPOLIS;1201;1200;2401;0,500208247;0,499791753
210240;CAJAPIO;5630;5625;11255;0,500222124;0,499777876
315900;SANTANA DO RIACHO;2168;2166;4334;0,500230734;0,499769266
510490;JANGADA;4212;4208;8420;0,50023753;0,49976247
261300;SAO BENTO DO UNA;30298;30269;60567;0,500239404;0,499760596
431645;SALTO DO JACUI;6259;6253;12512;0,50023977;0,49976023
412680;TAPEJARA;8244;8236;16480;0,500242718;0,499757282
220779;PAU D'ARCO DO PIAUI;2043;2041;4084;0,500244858;0,499755142
420490;DESCANSO;4070;4066;8136;0,500245821;0,499754179
421670;SAO JOSE DO CEDRO;6909;6902;13811;0,500253421;0,499746579
250660;IBIARA;2940;2937;5877;0,500255232;0,499744768
355230;SUD MENNUCCI;3871;3867;7738;0,500258465;0,499741535
293100;TANHACU;10197;10186;20383;0,500269833;0,499730167
521640;PARAUNA;5497;5491;10988;0,500273025;0,499726975
500797;TAQUARUSSU;1795;1793;3588;0,500278707;0,499721293
250590;EMAS;1779;1777;3556;0,500281215;0,499718785
420850;ITUPORANGA;12817;12802;25619;0,500292751;0,499707249
411380;LUPIONOPOLIS;2486;2483;4969;0,500301872;0,499698128
353260;NHANDEARA;5791;5784;11575;0,500302376;0,499697624
431407;PASSO DO SOBRADO;3308;3304;6612;0,50030248;0,49969752
411965;PITANGUEIRAS;1650;1648;3298;0,500303214;0,499696786
170230;ARAPOEMA;3297;3293;6590;0,50030349;0,49969651
412330;SANTA CRUZ DE MONTE CASTELO;3855;3850;7705;0,500324465;0,499675535
221170;WALL FERRAZ;2241;2238;4479;0,500334896;0,499665104
231210;SANTANA DO CARIRI;8869;8857;17726;0,500338486;0,499661514
410425;CAMPO MAGRO;15086;15065;30151;0,500348247;0,499651753
355450;TIETE;21488;21458;42946;0,500349276;0,499650724
292140;MIRANGABA;9308;9295;18603;0,500349406;0,499650594
211195;SUCUPIRA DO RIACHAO;2848;2844;5692;0,50035137;0,49964863
352080;INUBIA PAULISTA;2024;2021;4045;0,500370828;0,499629172
310710;BOA ESPERANCA;20169;20139;40308;0,500372135;0,499627865
210140;BALSAS;48512;48439;96951;0,500376479;0,499623521
270110;BRANQUINHA;5217;5209;10426;0,500383656;0,499616344
355380;TAQUARITUBA;11655;11637;23292;0,500386399;0,499613601
313180;ITABIRINHA;5823;5814;11637;0,500386698;0,499613302
172000;SANTA TEREZINHA DO TOCANTINS;1266;1264;2530;0,500395257;0,499604743
310700;BIQUINHAS;1242;1240;2482;0,500402901;0,499597099
241310;SENADOR ELOI DE SOUZA;3086;3081;6167;0,500405383;0,499594617
355130;SEBASTIANOPOLIS DO SUL;1799;1796;3595;0,500417246;0,499582754
314160;MERCES;5392;5383;10775;0,500417633;0,499582367
250580;DUAS ESTRADAS;1786;1783;3569;0,500420286;0,499579714
431380;PALMITINHO;3531;3525;7056;0,50042517;0,49957483
432237;UNISTALDA;1154;1152;2306;0,500433651;0,499566349
350925;CAJATI;14233;14208;28441;0,500439506;0,499560494
330010;ANGRA DOS REIS;105178;104993;210171;0,500440118;0,499559882
521480;NOVA AURORA;1119;1117;2236;0,500447227;0,499552773
352115;IPIGUA;2781;2776;5557;0,500449883;0,499550117
411065;IRACEMA DO OESTE;1109;1107;2216;0,500451264;0,499548736
410990;ICARAIMA;3839;3832;7671;0,500456264;0,499543736
230030;ACOPIARA;27370;27317;54687;0,500484576;0,499515424
220272;COCAL DOS ALVES;3093;3087;6180;0,500485437;0,499514563
260800;JATAUBA;8661;8644;17305;0,500491188;0,499508812
412520;SAO JORGE D'OESTE;4507;4498;9005;0,500499722;0,499500278
311820;CONQUISTA;3502;3495;6997;0,500500214;0,499499786
354820;SANTO ANTONIO DO PINHAL;3425;3418;6843;0,500511472;0,499488528
291810;JEREMOABO;20437;20395;40832;0,500514303;0,499485697
314460;NEPOMUCENO;13455;13427;26882;0,500520795;0,499479205
410510;CENTENARIO DO SUL;5358;5346;10704;0,500560538;0,499439462
293130;TAPIRAMUTA;8479;8460;16939;0,500560836;0,499439164
150613;REDENCAO;43212;43114;86326;0,500567616;0,499432384
210780;PARNARAMA;17574;17534;35108;0,500569671;0,499430329
260930;MIRANDIBA;7783;7765;15548;0,500578853;0,499421147
315790;SANTA MARGARIDA;8206;8187;16393;0,500579516;0,499420484
411800;PARAISO DO NORTE;7114;7097;14211;0,500598128;0,499401872
292460;PINDOBACU;10036;10012;20048;0,500598563;0,499401437
353780;PIEDADE;27899;27832;55731;0,500601102;0,499398898
352580;JULIO MESQUITA;2415;2409;4824;0,500621891;0,499378109
500470;IVINHEMA;11653;11624;23277;0,500622933;0,499377067
320340;MIMOSO DO SUL;13056;13023;26079;0,500632693;0,499367307
411030;INAJA;1563;1559;3122;0,500640615;0,499359385
251560;SERRA DA RAIZ;1559;1555;3114;0,500642261;0,499357739
410610;CONSELHEIRO MAIRINCK;1948;1943;3891;0,500642508;0,499357492
312540;FELICIO DOS SANTOS;2331;2325;4656;0,50064433;0,49935567
312390;ENTRE RIOS DE MINAS;7739;7719;15458;0,500646914;0,499353086
110009;ESPIGAO D'OESTE;16526;16483;33009;0,500651338;0,499348662
211153;SAO PEDRO DA AGUA BRANCA;6398;6381;12779;0,500665154;0,499334846
261350;SAO JOSE DO BELMONTE;17064;17018;34082;0,500674843;0,499325157
411530;MARIOPOLIS;3332;3323;6655;0,500676183;0,499323817
220253;CARAUBAS DO PIAUI;2959;2951;5910;0,500676819;0,499323181
412220;RIO BRANCO DO SUL;16340;16295;32635;0,500689444;0,499310556
210565;JUNCO DO MARANHAO;2170;2164;4334;0,500692201;0,499307799
220554;LAGOINHA DO PIAUI;1437;1433;2870;0,500696864;0,499303136
231380;URUBURETAMA;11127;11096;22223;0,500697476;0,499302524
430745;ESPERANCA DO SUL;1425;1421;2846;0,500702741;0,499297259
312220;DIVINOLANDIA DE MINAS;3833;3822;7655;0,500718485;0,499281515
250960;MONTE HOREBE;2437;2430;4867;0,500719129;0,499280871
351990;IEPE;4120;4108;8228;0,500729217;0,499270783
421290;PINHALZINHO;10567;10536;21103;0,500734493;0,499265507
521500;NOVA VENEZA;5104;5089;10193;0,500735799;0,499264201
210390;DUQUE BACELAR;5734;5717;11451;0,500742293;0,499257707
312000;CORREGO NOVO;1346;1342;2688;0,500744048;0,499255952
313060;INCONFIDENTES;3699;3688;7387;0,500744551;0,499255449
421180;OURO;3631;3620;7251;0,500758516;0,499241484
230205;BARROQUINHA;7546;7523;15069;0,500763156;0,499236844
315270;PRADOS;4571;4557;9128;0,500766871;0,499233129
500620;NOVA ANDRADINA;28072;27985;56057;0,500775996;0,499224004
520025;AGUAS LINDAS DE GOIAS;111599;111251;222850;0,500780794;0,499219206
315540;RIO NOVO;4489;4475;8964;0,500780901;0,499219099
420890;JARAGUA DO SUL;92436;92143;184579;0,500793698;0,499206302
241340;SERRA NEGRA DO NORTE;4059;4046;8105;0,500801974;0,499198026
330310;NATIVIDADE;7665;7640;15305;0,500816727;0,499183273
351710;GLICERIO;2425;2417;4842;0,500826105;0,499173895
290290;BARRA DO CHOCA;15441;15390;30831;0,50082709;0,49917291
231070;PENTECOSTE;19054;18991;38045;0,500827967;0,499172033
230570;IPAUMIRIM;6264;6243;12507;0,50083953;0,49916047
230520;HIDROLANDIA;10080;10046;20126;0,500844679;0,499155321
351130;CEDRAL;4734;4718;9452;0,500846382;0,499153618
270320;IGREJA NOVA;12356;12314;24670;0,500851236;0,499148764
330500;SAO JOAO DA BARRA;18397;18334;36731;0,500857586;0,499142414
315240;POTE;8352;8323;16675;0,500869565;0,499130435
350170;AMERICO BRASILIENSE;20809;20736;41545;0,500878565;0,499121435
500280;CARACOL;3129;3118;6247;0,500880423;0,499119577
412125;RAMILANDIA;2254;2246;4500;0,500888889;0,499111111
293076;SITIO DO QUINTO;4724;4707;9431;0,500901283;0,499098717
260160;BELEM DE SAO FRANCISCO;10384;10346;20730;0,500916546;0,499083454
410752;ESPERANCA NOVA;818;815;1633;0,500918555;0,499081445
350270;APIAI;12063;12018;24081;0,500934347;0,499065653
291310;IBITITA;8540;8508;17048;0,500938527;0,499061473
330475;SAO FRANCISCO DE ITABAPOANA;21147;21067;42214;0,500947553;0,499052447
171070;ITAGUATINS;2906;2895;5801;0,500948112;0,499051888
241290;SAO TOME;5536;5515;11051;0,50095014;0,49904986
320200;DORES DO RIO PRETO;3403;3390;6793;0,500956867;0,499043133
290035;ADUSTINA;8621;8588;17209;0,500958801;0,499041199
260200;BODOCO;19340;19265;38605;0,500971377;0,499028623
291440;IRAQUARA;12889;12839;25728;0,500971704;0,499028296
431215;MATO LEITAO;2318;2309;4627;0,500972552;0,499027448
317110;VERISSIMO;2049;2041;4090;0,500977995;0,499022005
150130;BARCARENA;64793;64540;129333;0,500978095;0,499021905
270210;COLONIA LEOPOLDINA;10989;10946;21935;0,500980169;0,499019831
353180;MONTE MOR;30914;30793;61707;0,50098044;0,49901956
314655;PAI PEDRO;3055;3043;6098;0,500983929;0,499016071
220455;GUARIBAS;2291;2282;4573;0,500984037;0,499015963
291905;LAJEDO DO TABOCAL;4304;4287;8591;0,500989408;0,499010592
290115;AMERICA DOURADA;8059;8027;16086;0,500994654;0,499005346
312083;CUPARAQUE;2518;2508;5026;0,500994827;0,499005173
290380;BOA VISTA DO TUPIM;9264;9227;18491;0,501000487;0,498999513
352140;IRACEMAPOLIS;12516;12466;24982;0,501000721;0,498999279
351070;CARDOSO;6198;6173;12371;0,501010428;0,498989572
315730;SANTA BARBARA DO TUGURIO;2197;2188;4385;0,501026226;0,498973774
432330;VILA FLORES;1707;1700;3407;0,501027297;0,498972703
290405;BONITO;8517;8482;16999;0,501029472;0,498970528
210255;CAMPESTRE DO MARANHAO;7280;7250;14530;0,501032347;0,498967653
220209;CALDEIRAO GRANDE DO PIAUI;2899;2887;5786;0,501036986;0,498963014
290240;AURELINO LEAL;5551;5528;11079;0,501038;0,498962
220510;ITAUEIRA;5530;5507;11037;0,50104195;0,49895805
261270;SANTA MARIA DO CAMBUCA;7169;7139;14308;0,501048365;0,498951635
280530;PIRAMBU;4728;4708;9436;0,501059771;0,498940229
270010;AGUA BRANCA;10153;10110;20263;0,501061047;0,498938953
230330;CARIUS;9370;9330;18700;0,501069519;0,498930481
521560;PADRE BERNARDO;17543;17468;35011;0,501071092;0,498928908
292220;MUNIZ FERREIRA;3740;3724;7464;0,501071811;0,498928189
432162;TRAVESSEIRO;1168;1163;2331;0,501072501;0,498927499
352420;JABORANDI;3489;3474;6963;0,501077122;0,498922878
430480;CARLOS BARBOSA;15348;15282;30630;0,501077375;0,498922625
420990;LONTRAS;6262;6235;12497;0,501080259;0,498919741
251640;TACIMA;5524;5500;11024;0,501088534;0,498911466
291230;IBICUI;8149;8113;16262;0,501106875;0,498893125
230180;BAIXIO;3166;3152;6318;0,501107946;0,498892054
431402;PARAISO DO SUL;3826;3809;7635;0,501113294;0,498886706
314310;MONTE CARMELO;24078;23971;48049;0,501113447;0,498886553
290190;APORA;8940;8900;17840;0,501121076;0,498878924
316220;SAO JOAO BATISTA DO GLORIA;3779;3762;7541;0,501127171;0,498872829
250855;LOGRADOURO;2208;2198;4406;0,501134816;0,498865184
220795;NOVA SANTA RITA;2201;2191;4392;0,501138434;0,498861566
290300;BARRA DO MENDES;6579;6549;13128;0,501142596;0,498857404
520880;GOIANIRA;23193;23085;46278;0,501166861;0,498833139
410442;CANDOI;8082;8044;16126;0,501178222;0,498821778
354560;SANTA ADELIA;7838;7801;15639;0,50118294;0,49881706
431880;SAO LOURENCO DO SUL;21802;21699;43501;0,501183881;0,498816119
352910;MARINOPOLIS;1053;1048;2101;0,50118991;0,49881009
316210;SAO GOTARDO;18085;17999;36084;0,501191664;0,498808336
315260;POUSO ALTO;2938;2924;5862;0,501194132;0,498805868
330575;TANGUA;17491;17407;34898;0,501203507;0,498796493
421535;SALTINHO;1868;1859;3727;0,501207405;0,498792595
353210;MURUTINGA DO SUL;2268;2257;4525;0,50121547;0,49878453
312150;DESTERRO DO MELO;1437;1430;2867;0,501220788;0,498779212
313860;LIMA DUARTE;8395;8354;16749;0,501223954;0,498776046
292820;SANTANA;13429;13363;26792;0,501231711;0,498768289
410322;BOM SUCESSO DO SUL;1626;1618;3244;0,501233046;0,498766954
260660;IBIMIRIM;14829;14756;29585;0,501233733;0,498766267
270650;PASSO DE CAMARAGIBE;7654;7616;15270;0,50124427;0,49875573
320016;AGUA DOCE DO NORTE;5414;5387;10801;0,501249884;0,498750116
240270;CERRO CORA;5605;5577;11182;0,501252012;0,498747988
355580;URANIA;4574;4551;9125;0,501260274;0,498739726
280640;SANTANA DO SAO FRANCISCO;3963;3943;7906;0,501264862;0,498735138
430675;DOUTOR RICARDO;986;981;1967;0,501270971;0,498729029
410890;GUAIRACA;3326;3309;6635;0,501281085;0,498718915
290040;AGUA FRIA;8570;8526;17096;0,501286851;0,498713149
312570;FELIXLANDIA;7784;7744;15528;0,501287996;0,498712004
432057;SETE DE SETEMBRO;968;963;1931;0,501294666;0,498705334
351830;GUARAREMA;15272;15193;30465;0,50129657;0,49870343
240470;IPANGUACU;7900;7859;15759;0,501300844;0,498699156
241160;SAO BENTO DO NORTE;1347;1340;2687;0,501302568;0,498697432
520360;BRAZABRANTES;1911;1901;3812;0,501311647;0,498688353
313800;LARANJAL;3437;3419;6856;0,501312719;0,498687281
350290;ARACOIABA DA SERRA;17741;17648;35389;0,501313968;0,498686032
520215;ARAGUAPAZ;3908;3887;7795;0,501347017;0,498652983
352820;MACEDONIA;1848;1838;3686;0,501356484;0,498643516
230910;MULUNGU;5543;5513;11056;0,501356729;0,498643271
430170;BARAO DE COTEGIPE;3317;3299;6616;0,501360339;0,498639661
354150;PRESIDENTE VENCESLAU;19878;19770;39648;0,501361985;0,498638015
355440;TERRA ROXA;4764;4738;9502;0,501368133;0,498631867
320334;MARECHAL FLORIANO;8594;8547;17141;0,501370982;0,498629018
310430;AREADO;7665;7623;15288;0,501373626;0,498626374
311130;CAMPO DO MEIO;5840;5808;11648;0,501373626;0,498626374
292060;MARAGOGIPE;22513;22389;44902;0,501380785;0,498619215
210210;BREJO;18501;18399;36900;0,501382114;0,498617886
230393;CHORO;6823;6785;13608;0,501396238;0,498603762
353475;OUROESTE;5371;5341;10712;0,501400299;0,498599701
411240;JAPURA;4800;4773;9573;0,501410216;0,498589784
210220;BURITI;14499;14417;28916;0,5014179;0,4985821
320010;AFONSO CLAUDIO;15206;15120;30326;0,501417925;0,498582075
510343;CURVELANDIA;2641;2626;5267;0,501423961;0,498576039
211170;SAO VICENTE FERRER;11258;11194;22452;0,501425263;0,498574737
290860;CONDE;13149;13074;26223;0,501430042;0,498569958
431171;MACAMBARA;2276;2263;4539;0,501432033;0,498567967
431242;MORMACO;1574;1565;3139;0,501433578;0,498566422
270375;JEQUIA DA PRAIA;5764;5731;11495;0,501435407;0,498564593
431650;SALVADOR DO SUL;3999;3976;7975;0,501442006;0,498557994
313910;MADRE DE DEUS DE MINAS;2567;2552;5119;0,50146513;0,49853487
353280;NOVA ALIANCA;3591;3570;7161;0,501466276;0,498533724
210312;CENTRAL DO MARANHAO;4416;4390;8806;0,501476266;0,498523734
316200;SAO GONCALO DO SAPUCAI;12873;12797;25670;0,501480327;0,498519673
412660;SIQUEIRA CAMPOS;10770;10706;21476;0,501490035;0,498509965
432040;SERAFINA CORREA;9064;9010;18074;0,501493859;0,498506141
330015;APERIBE;6036;6000;12036;0,501495513;0,498504487
311610;CHAPADA DO NORTE;7690;7644;15334;0,501499935;0,498500065
220070;ANISIO DE ABREU;5012;4982;9994;0,501500901;0,498499099
412796;TURVO;6508;6469;12977;0,501502659;0,498497341
430642;DOIS IRMAOS DAS MISSOES;999;993;1992;0,501506024;0,498493976
292610;RETIROLANDIA;7316;7272;14588;0,501508089;0,498491911
280040;ARAUA;4935;4905;9840;0,50152439;0,49847561
430410;CAMPOS BORGES;1641;1631;3272;0,501528117;0,498471883
210890;POCAO DE PEDRAS;8687;8634;17321;0,501529935;0,498470065
313720;LAGOA DA PRATA;26700;26536;53236;0,501540311;0,498459689
220205;CABECEIRAS DO PIAUI;5352;5319;10671;0,501546247;0,498453753
291500;ITAETE;8107;8057;16164;0,501546647;0,498453353
231370;UMARI;3882;3858;7740;0,501550388;0,498449612
260870;LAGOA DOS GATOS;8198;8147;16345;0,50156011;0,49843989
430120;ARROIO DO TIGRE;6747;6705;13452;0,501561106;0,498438894
320503;VARGEM ALTA;10923;10855;21778;0,501561209;0,498438791
270090;BELO MONTE;3369;3348;6717;0,501563198;0,498436802
251720;VIEIROPOLIS;2706;2689;5395;0,501575533;0,498424467
250310;CABACEIRAS;2864;2846;5710;0,501576182;0,498423818
172097;TALISMA;1420;1411;2831;0,501589544;0,498410456
421565;SANTA ROSA DO SUL;4212;4185;8397;0,501607717;0,498392283
312015;CRISOLITA;3418;3396;6814;0,501614323;0,498385677
211000;SANTA LUZIA;36671;36434;73105;0,501620956;0,498379044
510790;SINOP;74722;74238;148960;0,501624597;0,498375403
351430;DOURADO;4456;4427;8883;0,501632331;0,498367669
230660;ITATIRA;11045;10973;22018;0,501635026;0,498364974
231390;URUOCA;7017;6971;13988;0,501644267;0,498355733
421260;PERITIBA;1371;1362;2733;0,501646542;0,498353458
290700;CARDEAL DA SILVA;4713;4682;9395;0,501649814;0,498350186
240140;BAIA FORMOSA;4702;4671;9373;0,501653686;0,498346314
314040;MARMELOPOLIS;1355;1346;2701;0,50166605;0,49833395
521550;OUVIDOR;3459;3436;6895;0,501667875;0,498332125
270600;OLIVENCA;5860;5821;11681;0,501669378;0,498330622
421210;PALMITOS;8099;8045;16144;0,501672448;0,498327552
231240;SAO GONCALO DO AMARANTE;24736;24570;49306;0,501683365;0,498316635
170930;GUARAI;13246;13157;26403;0,501685415;0,498314585
260825;JUCATI;5792;5753;11545;0,501689043;0,498310957
292810;SANTA MARIA DA VITORIA;19921;19786;39707;0,501699952;0,498300048
290680;CANSANCAO;17524;17405;34929;0,501703456;0,498296544
317160;VIRGEM DA LAPA;6888;6841;13729;0,501711705;0,498288295
150170;BRAGANCA;65284;64838;130122;0,501713776;0,498286224
351730;GUAIMBE;2913;2893;5806;0,501722356;0,498277644
260320;CAETES;14583;14482;29065;0,501737485;0,498262515
220270;COCAL;13999;13902;27901;0,501738289;0,498261711
420150;ARMAZEM;4437;4406;8843;0,501752799;0,498247201
291340;IGAPORA;7858;7803;15661;0,501755954;0,498244046
311910;CORINTO;11845;11762;23607;0,501757953;0,498242047
120025;EPITACIOLANDIA;9523;9456;18979;0,501765109;0,498234891
291220;IBICOARA;10031;9959;19990;0,5018009;0,4981991
521030;ISRAELANDIA;1391;1381;2772;0,501803752;0,498196248
510795;TANGARA DA SERRA;54010;53621;107631;0,5018071;0,4981929
210207;BOM LUGAR;8319;8259;16578;0,501809627;0,498190373
220965;SAO FRANCISCO DE ASSIS DO PIAUI;2911;2890;5801;0,501810033;0,498189967
421750;SEARA;8837;8773;17610;0,501817149;0,498182851
352990;MIRACATU;9791;9720;19511;0,501819486;0,498180514
250900;MANAIRA;5514;5474;10988;0,501820167;0,498179833
421910;VARGEAO;1791;1778;3569;0,501821238;0,498178762
522026;SAO MIGUEL DO PASSA QUATRO;2060;2045;4105;0,50182704;0,49817296
420075;ALTO BELA VISTA;961;954;1915;0,501827676;0,498172324
500830;TRES LAGOAS;62800;62337;125137;0,501849972;0,498150028
411620;MORRETES;8273;8212;16485;0,501850167;0,498149833
353200;MORUNGABA;6994;6942;13936;0,501865672;0,498134328
410445;CANTAGALO;6695;6645;13340;0,501874063;0,498125937
211227;TUFILANDIA;2945;2923;5868;0,501874574;0,498125426
432255;VANINI;1069;1061;2130;0,501877934;0,498122066
431220;MAXIMILIANO DE ALMEIDA;2135;2119;4254;0,501880583;0,498119417
421875;TUNAPOLIS;2262;2245;4507;0,501885955;0,498114045
431513;POUSO NOVO;796;790;1586;0,501891551;0,498108449
316600;SENHORA DE OLIVEIRA;2904;2882;5786;0,501901141;0,498098859
352670;LEME;52837;52436;105273;0,501904572;0,498095428
315895;SANTANA DO PARAISO;18093;17955;36048;0,501914115;0,498085885
320370;MUNIZ FREIRE;8621;8555;17176;0,501921286;0,498078714
290230;ARATUIPE;4441;4407;8848;0,501921338;0,498078662
241090;RIACHUELO;4171;4139;8310;0,501925391;0,498074609
330140;CONCEICAO DE MACABU;11826;11735;23561;0,501931157;0,498068843
431230;MIRAGUAI;2459;2440;4899;0,501939171;0,498060829
330160;DUAS BARRAS;5804;5759;11563;0,501945862;0,498054138
210720;NINA RODRIGUES;7442;7384;14826;0,501956023;0,498043977
292205;MULUNGU DO MORRO;5255;5214;10469;0,501958162;0,498041838
313030;IGUATAMA;3966;3935;7901;0,501961777;0,498038223
320040;ANCHIETA;15202;15083;30285;0,501964669;0,498035331
520495;CAMPOS VERDES;766;760;1526;0,501965924;0,498034076
420020;AGROLANDIA;5602;5558;11160;0,501971326;0,498028674
520400;CABECEIRAS;4065;4033;8098;0,501975796;0,498024204
315630;RODEIRO;4183;4150;8333;0,501980079;0,498019921
310300;ANTONIO DIAS;4635;4598;9233;0,502003682;0,497996318
421600;SAO CARLOS;5751;5705;11456;0,502007682;0,497992318
171855;RIACHINHO;2371;2352;4723;0,502011433;0,497988567
350560;BARRINHA;16836;16701;33537;0,502012702;0,497987298
312235;DIVISA ALEGRE;3487;3459;6946;0,502015549;0,497984451
280700;SAO MIGUEL DO ALEIXO;1990;1974;3964;0,502018163;0,497981837
314015;MARIO CAMPOS;7939;7875;15814;0,502023523;0,497976477
315740;SANTA CRUZ DO ESCALVADO;2356;2337;4693;0,502024291;0,497975709
290540;CAIRU;9371;9295;18666;0,502035787;0,497964213
210110;AXIXA;6142;6092;12234;0,502043485;0,497956515
231025;PARAIPABA;16684;16548;33232;0,502046221;0,497953779
355120;SARUTAIA;1819;1804;3623;0,502070108;0,497929892
260040;AGUA PRETA;18771;18615;37386;0,502086342;0,497913658
350995;CANAS;2645;2623;5268;0,502088079;0,497911921
251710;VARZEA;1441;1429;2870;0,502090592;0,497909408
260820;JOAQUIM NABUCO;8033;7966;15999;0,502093881;0,497906119
211003;SANTA LUZIA DO PARUA;12797;12690;25487;0,502099109;0,497900891
431267;NICOLAU VERGUEIRO;837;830;1667;0,50209958;0,49790042
350690;BOFETE;6079;6028;12107;0,50210622;0,49789378
420640;GUARACIABA;5003;4961;9964;0,502107587;0,497892413
350310;ARANDU;3200;3173;6373;0,502118312;0,497881688
221040;SAO MIGUEL DO TAPUIO;8846;8771;17617;0,502128626;0,497871374
521930;SANTA HELENA DE GOIAS;19564;19398;38962;0,502130281;0,497869719
521056;ITAGUARI;2352;2332;4684;0,502134927;0,497865073
431531;QUATRO IRMAOS;934;926;1860;0,502150538;0,497849462
430064;AMETISTA DO SUL;3714;3682;7396;0,502163332;0,497836668
311930;COROMANDEL;14040;13918;27958;0,502181844;0,497818156
220280;CONCEICAO DO CANINDE;2416;2395;4811;0,502182498;0,497817502
350680;BOCAINA;6313;6258;12571;0,502187575;0,497812425
241070;RIACHO DA CRUZ;1832;1816;3648;0,502192982;0,497807018
220310;CRISTINO CASTRO;5255;5209;10464;0,502198012;0,497801988
150840;XINGUARA;22808;22608;45416;0,502201867;0,497798133
520170;ARAGARCAS;10250;10160;20410;0,502204802;0,497795198
130406;TABATINGA;34404;34098;68502;0,502233511;0,497766489
412370;SANTA ISABEL DO IVAI;4261;4223;8484;0,50223951;0,49776049
521190;JATAI;51842;51379;103221;0,502242761;0,497757239
421800;TIJUCAS;20034;19855;39889;0,502243726;0,497756274
220465;ILHA GRANDE;4765;4722;9487;0,502266259;0,497733741
411810;PARANACITY;5869;5816;11685;0,502267865;0,497732135
521380;MORRINHOS;23584;23371;46955;0,502268129;0,497731871
316890;TIROS;3199;3170;6369;0,502276653;0,497723347
310010;ABADIA DOS DOURADOS;3527;3495;7022;0,502278553;0,497721447
150630;SALVATERRA;12252;12140;24392;0,502295835;0,497704165
350990;CANANEIA;6300;6242;12542;0,502312231;0,497687769
315200;POMPEU;16199;16049;32248;0,502325726;0,497674274
521860;RIALMA;5506;5455;10961;0,50232643;0,49767357
320090;BARRA DE SAO FRANCISCO;22756;22545;45301;0,502328867;0,497671133
351250;COROADOS;3113;3084;6197;0,502339842;0,497660158
330240;MACAE;133691;132445;266136;0,502340908;0,497659092
150560;PEIXE-BOI;4061;4023;8084;0,502350322;0,497649678
220380;FLORES DO PIAUI;2241;2220;4461;0,502353732;0,497646268
412545;SAO JOSE DAS PALMEIRAS;1809;1792;3601;0,502360455;0,497639545
310480;AUGUSTO DE LIMA;2428;2405;4833;0,502379474;0,497620526
110100;GOVERNADOR JORGE TEIXEIRA;3582;3548;7130;0,502384292;0,497615708
352610;JUQUIA;9358;9269;18627;0,502389005;0,497610995
352230;ITAPETININGA;83953;83153;167106;0,50239369;0,49760631
500525;LAGUNA CARAPA;3766;3730;7496;0,502401281;0,497598719
352970;MIGUELOPOLIS;11294;11186;22480;0,502402135;0,497597865
210745;OLINDA NOVA DO MARANHAO;7520;7448;14968;0,502405131;0,497594869
420290;BRUSQUE;70639;69958;140597;0,502421816;0,497578184
412610;SAO TOME;2903;2875;5778;0,502422984;0,497577016
220730;PAES LANDIM;2072;2052;4124;0,50242483;0,49757517
150530;ORIXIMINA;37643;37278;74921;0,502435899;0,497564101
315220;PORTEIRINHA;19004;18819;37823;0,502445602;0,497554398
291085;FILADELFIA;8197;8117;16314;0,502451882;0,497548118
230070;ALTO SANTO;8078;7999;16077;0,502456926;0,497543074
431840;SAO JERONIMO;12345;12224;24569;0,502462453;0,497537547
280270;ILHA DAS FLORES;4282;4240;8522;0,50246421;0,49753579
210560;JOSELANDIA;8154;8074;16228;0,502464876;0,497535124
220105;ASSUNCAO DO PIAUI;3959;3920;7879;0,502474933;0,497525067
431245;MORRO REDONDO;3321;3288;6609;0,502496596;0,497503404
290350;BELO CAMPO;8549;8464;17013;0,50249809;0,49750191
330050;BOM JARDIM;13959;13820;27779;0,50250189;0,49749811
210900;PORTO FRANCO;12208;12086;24294;0,502510908;0,497489092
292935;SAO JOSE DA VITORIA;2795;2767;5562;0,50251708;0,49748292
431310;NOVA PALMA;3276;3243;6519;0,502531063;0,497468937
430220;BOA VISTA DO BURICA;3373;3339;6712;0,502532777;0,497467223
290370;BOA NOVA;6050;5989;12039;0,502533433;0,497466567
293250;UNA;9100;9008;18108;0,502540314;0,497459686
510010;ACORIZAL;2668;2641;5309;0,502542852;0,497457148
500480;JAPORA;4710;4662;9372;0,502560819;0,497439181
354430;ROSEIRA;5472;5416;10888;0,502571639;0,497428361
220190;BOM JESUS;12858;12726;25584;0,502579737;0,497420263
431330;NOVA PRATA;14083;13938;28021;0,502587345;0,497412655
313990;MARIA DA FE;7046;6973;14019;0,502603609;0,497396391
230810;MAURITI;24311;24059;48370;0,50260492;0,49739508
421810;TIMBE DO SUL;2683;2655;5338;0,502622705;0,497377295
320390;NOVA VENECIA;25509;25242;50751;0,50263049;0,49736951
260670;IBIRAJUBA;3907;3866;7773;0,502637334;0,497362666
432310;VICENTE DUTRA;2277;2253;4530;0,502649007;0,497350993
522157;UIRAPURU;1422;1407;2829;0,502651113;0,497348887
240090;ANTONIO MARTINS;3600;3562;7162;0,50265289;0,49734711
355430;TEODORO SAMPAIO;11760;11635;23395;0,502671511;0,497328489
351010;CANDIDO RODRIGUES;1410;1395;2805;0,502673797;0,497326203
430140;ARVOREZINHA;5239;5183;10422;0,502686624;0,497313376
314580;ONCA DE PITANGUI;1586;1569;3155;0,502694136;0,497305864
411535;MARIPA;2796;2766;5562;0,502696872;0,497303128
241330;SERRA DE SAO BENTO;2885;2854;5739;0,502700819;0,497299181
240240;CARNAUBA DOS DANTAS;4171;4126;8297;0,502711824;0,497288176
210200;BOM JARDIM;21119;20891;42010;0,50271364;0,49728636
220217;CAMPO LARGO DO PIAUI;3691;3651;7342;0,502724053;0,497275947
316350;SAO JOSE DO JACURI;3222;3187;6409;0,502730535;0,497269465
355490;TRES FRONTEIRAS;2944;2912;5856;0,50273224;0,49726776
500210;BELA VISTA;12489;12353;24842;0,5027373;0,4972627
293080;SOUTO SOARES;8606;8512;17118;0,502745648;0,497254352
251350;SANTANA DE MANGUEIRA;2563;2535;5098;0,502746175;0,497253825
431805;SAO DOMINGOS DO SUL;1554;1537;3091;0,502749919;0,497250081
293180;TREMEDAL;8042;7954;15996;0,502750688;0,497249312
510562;MIRASSOL D'OESTE;14145;13990;28135;0,502754576;0,497245424
521015;IPIRANGA DE GOIAS;1454;1438;2892;0,502766252;0,497233748
220997;SAO JOAO DO ARRAIAL;4065;4020;8085;0,502782931;0,497217069
250360;CAICARA;3611;3571;7182;0,50278474;0,49721526
240980;PEDRO VELHO;7482;7399;14881;0,502788791;0,497211209
316190;SAO GONCALO DO RIO ABAIXO;5588;5526;11114;0,502789275;0,497210725
311590;CHACARA;1617;1599;3216;0,502798507;0,497201493
292905;SAO FELIX DO CORIBE;7815;7728;15543;0,502798688;0,497201312
320405;PEDRO CANARIO;13362;13213;26575;0,502803387;0,497196613
352800;MACATUBA;8680;8583;17263;0,502809477;0,497190523
211085;SAO FRANCISCO DO BREJAO;6075;6007;12082;0,502814104;0,497185896
353580;PARANAPANEMA;10352;10236;20588;0,502817175;0,497182825
221080;SIMPLICIO MENDES;6425;6353;12778;0,502817342;0,497182658
150178;BREU BRANCO;34492;34105;68597;0,502820823;0,497179177
220335;DIRCEU ARCOVERDE;3543;3503;7046;0,50283849;0,49716151
310900;BRUMADINHO;20721;20487;41208;0,502839255;0,497160745
521308;MINACU;14340;14178;28518;0,502840311;0,497159689
171330;MIRANORTE;6814;6737;13551;0,502841119;0,497158881
354700;SANTA MARIA DA SERRA;3167;3131;6298;0,50285805;0,49714195
220025;ALAGOINHA DO PIAUI;3861;3817;7678;0,50286533;0,49713467
350640;BILAC;4122;4075;8197;0,502866903;0,497133097
110150;SERINGUEIRAS;5957;5889;11846;0,502870167;0,497129833
310820;BONFINOPOLIS DE MINAS;2714;2683;5397;0,502871966;0,497128034
320320;LINHARES;90395;89360;179755;0,502878919;0,497121081
291200;IBIASSUCE;4450;4399;8849;0,502881682;0,497118318
150796;TERRA ALTA;6020;5951;11971;0,502881965;0,497118035
220970;SAO FRANCISCO DO PIAUI;3227;3190;6417;0,502882967;0,497117033
150095;AURORA DO PARA;16193;16007;32200;0,502888199;0,497111801
510025;ALTA FLORESTA;26203;25902;52105;0,502888398;0,497111602
521210;JOVIANIA;3730;3687;7417;0,502898746;0,497101254
316410;SAO PEDRO DO SUACUI;2595;2565;5160;0,502906977;0,497093023
320050;APIACA;3793;3749;7542;0,502916998;0,497083002
410305;BOA VISTA DA APARECIDA;3784;3740;7524;0,502923977;0,497076023
314640;PAINEIRAS;2233;2207;4440;0,502927928;0,497072072
261580;TUPANATINGA;13978;13815;27793;0,502932393;0,497067607
316450;SAO SEBASTIAO DO MARANHAO;4971;4913;9884;0,502934035;0,497065965
314600;OURO FINO;17069;16869;33938;0,50294655;0,49705345
431337;NOVA SANTA RITA;15331;15151;30482;0,502952562;0,497047438
353215;NANTES;1617;1598;3215;0,502954899;0,497045101
313790;LAMIM;1693;1673;3366;0,502970885;0,497029115
314410;MUZAMBINHO;10322;10200;20522;0,50297242;0,49702758
432252;VALE VERDE;1776;1755;3531;0,502973662;0,497026338
316710;SERRO;10520;10395;20915;0,502988286;0,497011714
314340;MONTE SIAO;12196;12051;24247;0,502990061;0,497009939
500100;APARECIDA DO TABOADO;13272;13114;26386;0,502994012;0,497005988
351685;GAVIAO PEIXOTO;2435;2406;4841;0,502995249;0,497004751
210325;CIDELANDIA;7472;7383;14855;0,502995624;0,497004376
430705;ERNESTINA;1595;1576;3171;0,5029959;0,4970041
310920;BUENOPOLIS;5202;5140;10342;0,502997486;0,497002514
355730;ESTIVA GERBI;5788;5719;11507;0,502998175;0,497001825
292970;SATIRO DIAS;8717;8613;17330;0,503000577;0,496999423
431505;PORTO MAUA;1173;1159;2332;0,503001715;0,496998285
310375;ARAPORA;3517;3475;6992;0,503003432;0,496996568
170710;DIVINOPOLIS DO TOCANTINS;3514;3472;6986;0,503006012;0,496993988
314170;MESQUITA;2761;2728;5489;0,503006012;0,496993988
431460;PIRATINI;10434;10309;20743;0,503013065;0,496986935
430450;CANGUCU;28356;28014;56370;0,503033528;0,496966472
230750;LAVRAS DA MANGABEIRA;15834;15642;31476;0,503049943;0,496950057
310940;BURITIZEIRO;14178;14006;28184;0,503051377;0,496948623
310360;ARANTINA;1398;1381;2779;0,503058654;0,496941346
310260;ANDRADAS;20981;20723;41704;0,503093228;0,496906772
311770;CONCEICAO DO RIO VERDE;6907;6822;13729;0,503095637;0,496904363
421840;TREZE DE MAIO;3574;3530;7104;0,503096847;0,496903153
317030;UMBURATIBA;1299;1283;2582;0,503098373;0,496901627
230820;MERUOCA;7702;7607;15309;0,50310275;0,49689725
353282;NOVA CAMPINA;5012;4950;9962;0,503111825;0,496888175
500750;ROCHEDO;2576;2544;5120;0,503125;0,496875
316960;TUPACIGUARA;12813;12653;25466;0,503141443;0,496858557
411930;PINHAO;16464;16258;32722;0,503147729;0,496852271
240790;MONTE DAS GAMELEIRAS;1038;1025;2063;0,503150751;0,496849249
220675;NOSSA SENHORA DE NAZARE;2471;2440;4911;0,50315618;0,49684382
292370;PARATINGA;16239;16035;32274;0,503160439;0,496839561
431470;PLANALTO;5010;4947;9957;0,503163603;0,496836397
241470;VARZEA;2782;2747;5529;0,503165129;0,496834871
315290;PRATAPOLIS;4292;4238;8530;0,503165299;0,496834701
250053;ALCANTIL;2781;2746;5527;0,503166275;0,496833725
412730;TERRA RICA;8581;8473;17054;0,503166413;0,496833587
521040;ITABERAI;22305;22024;44329;0,503169483;0,496830517
350380;ARTUR NOGUEIRA;28302;27945;56247;0,503173503;0,496826497
290950;CRAVOLANDIA;2693;2659;5352;0,503176383;0,496823617
352290;ITAPUI;7194;7103;14297;0,503182486;0,496817514
352570;JOSE BONIFACIO;18974;18733;37707;0,503195693;0,496804307
351280;COSMOPOLIS;37570;37092;74662;0,503201093;0,496798907
310460;ASTOLFO DUTRA;7225;7133;14358;0,503203789;0,496796211
320245;IBATIBA;13467;13295;26762;0,503213512;0,496786488
354290;RIBEIRAO BONITO;6731;6645;13376;0,503214713;0,496785287
354805;SANTO ANTONIO DO ARACANGUA;4298;4243;8541;0,503219763;0,496780237
431415;PAVERAMA;4298;4243;8541;0,503219763;0,496780237
230100;AQUIRAZ;41054;40527;81581;0,503229919;0,496770081
351905;HOLAMBRA;7853;7752;15605;0,503236142;0,496763858
410170;ARARUNA;7060;6969;14029;0,503243282;0,496756718
221135;VARZEA BRANCA;2481;2449;4930;0,503245436;0,496754564
171575;PALMEIROPOLIS;3872;3822;7694;0,503249285;0,496750715
230365;CATUNDA;5239;5171;10410;0,50326609;0,49673391
170320;BERNARDO SAYAO;2234;2205;4439;0,503266501;0,496733499
510715;RESERVA DO CABACAL;1386;1368;2754;0,503267974;0,496732026
421390;PRESIDENTE CASTELLO BRANCO;768;758;1526;0,50327654;0,49672346
316105;SAO FELIX DE MINAS;1688;1666;3354;0,503279666;0,496720334
420600;GOVERNADOR CELSO RAMOS;7418;7321;14739;0,50329059;0,49670941
311680;COLUNA;4434;4376;8810;0,503291714;0,496708286
352010;IGARAPAVA;15497;15294;30791;0,503296418;0,496703582
240760;MESSIAS TARGINO;2348;2317;4665;0,503322615;0,496677385
521230;LEOPOLDO DE BULHOES;3857;3806;7663;0,503327678;0,496672322
250840;LASTRO;1358;1340;2698;0,503335804;0,496664196
241080;RIACHO DE SANTANA;2111;2083;4194;0,503338102;0,496661898
231335;TEJUCUOCA;9841;9710;19551;0,503350212;0,496649788
292560;PRESIDENTE DUTRA;7641;7539;15180;0,503359684;0,496640316
316840;TARUMIRIM;7188;7092;14280;0,503361345;0,496638655
500635;PARANHOS;7337;7239;14576;0,50336169;0,49663831
110029;SANTA LUZIA D'OESTE;2991;2951;5942;0,50336587;0,49663413
315213;PONTO CHIQUE;2167;2138;4305;0,503368177;0,496631823
241010;POCO BRANCO;7876;7770;15646;0,503387447;0,496612553
410230;BALSA NOVA;6664;6574;13238;0,503399305;0,496600695
410270;BARRA DO JACARE;1400;1381;2781;0,503416037;0,496583963
290960;CRISOPOLIS;10682;10537;21219;0,503416749;0,496583251
250535;DAMIAO;2723;2686;5409;0,503420226;0,496579774
172093;TAIPAS DO TOCANTINS;1099;1084;2183;0,503435639;0,496564361
250420;CATINGUEIRA;2486;2452;4938;0,503442689;0,496557311
355150;SERRANA;23242;22924;46166;0,503444093;0,496555907
313700;LADAINHA;9199;9073;18272;0,503447898;0,496552102
510130;ARENAPOLIS;4732;4667;9399;0,503457815;0,496542185
313690;JURUAIA;5435;5360;10795;0,50347383;0,49652617
521600;PANAMA;1304;1286;2590;0,503474903;0,496525097
410250;BARBOSA FERRAZ;5683;5604;11287;0,503499601;0,496500399
270460;MARAVILHA;4456;4394;8850;0,503502825;0,496497175
411610;MOREIRA SALES;6025;5941;11966;0,503509945;0,496490055
521377;MONTIVIDIU DO NORTE;2285;2253;4538;0,503525782;0,496474218
310380;ARAPUA;1428;1408;2836;0,503526093;0,496473907
314590;OURO BRANCO;20252;19968;40220;0,503530582;0,496469418
230460;GENERAL SAMPAIO;3911;3856;7767;0,503540621;0,496459379
432185;TRES PALMEIRAS;2131;2101;4232;0,503544423;0,496455577
312880;GUIDOVAL;3538;3488;7026;0,503558212;0,496441788
310490;BAEPENDI;9693;9556;19249;0,503558626;0,496441374
220435;GEMINIANO;2758;2719;5477;0,503560343;0,496439657
431844;SAO JORGE;1414;1394;2808;0,503561254;0,496438746
351520;ESTRELA D'OESTE;4240;4180;8420;0,503562945;0,496437055
520760;FAZENDA NOVA;2755;2716;5471;0,503564248;0,496435752
251465;SAO JOSE DO BREJO DO CRUZ;917;904;1821;0,503569467;0,496430533
291570;ITAMARI;4014;3957;7971;0,503575461;0,496424539
431238;MONTE BELO DO SUL;1266;1248;2514;0,503579952;0,496420048
316500;SAO TIAGO;5529;5450;10979;0,503597778;0,496402222
351650;GABRIEL MONTEIRO;1398;1378;2776;0,503602305;0,496397695
421320;POMERODE;17405;17156;34561;0,503602326;0,496397674
350075;ALAMBARI;3138;3093;6231;0,503610977;0,496389023
320440;RIO NOVO DO SUL;5857;5773;11630;0,50361135;0,49638865
510628;NOVO SAO JOAQUIM;2436;2401;4837;0,503617945;0,496382055
241190;SAO FRANCISCO DO OESTE;2156;2125;4281;0,503620649;0,496379351
220630;MIGUEL LEAO;624;615;1239;0,503631961;0,496368039
350840;CABREUVA;25751;25379;51130;0,503637786;0,496362214
353310;NOVA GUATAPORANGA;1175;1158;2333;0,503643378;0,496356622
230510;GUARAMIRANGA;2555;2518;5073;0,503646757;0,496353243
310030;ABRE CAMPO;6766;6668;13434;0,503647462;0,496352538
240725;MAJOR SALES;2066;2036;4102;0,503656753;0,496343247
315820;SANTA MARIA DO SUACUI;7357;7250;14607;0,503662628;0,496337372
230565;IPAPORANGA;5841;5756;11597;0,503664741;0,496335259
317100;VAZANTE;10422;10270;20692;0,503672917;0,496327083
351900;HERCULANDIA;4860;4789;9649;0,503679138;0,496320862
150760;SAO MIGUEL DO GUAMA;30356;29912;60268;0,503683547;0,496316453
270920;TRAIPU;14070;13864;27934;0,503687263;0,496312737
171880;SAMPAIO;2456;2420;4876;0,50369155;0,49630845
210010;AFONSO CUNHA;3340;3291;6631;0,503694767;0,496305233
250380;CALDAS BRANDAO;3061;3016;6077;0,503702485;0,496297515
291820;JIQUIRICA;7342;7234;14576;0,50370472;0,49629528
150340;INHANGAPI;6049;5960;12009;0,503705554;0,496294446
210547;JENIPAPO DOS VIEIRAS;8625;8498;17123;0,503708462;0,496291538
220155;BELA VISTA DO PIAUI;2037;2007;4044;0,503709199;0,496290801
420775;IRACEMINHA;1965;1936;3901;0,503716996;0,496283004
521180;JARAGUA;26274;25886;52160;0,503719325;0,496280675
431935;SAO PEDRO DA SERRA;1955;1926;3881;0,50373615;0,49626385
250710;ITAPOROROCA;9560;9418;18978;0,503741174;0,496258826
315765;SANTA HELENA DE MINAS;3227;3179;6406;0,503746488;0,496253512
312530;FARIA LEMOS;1613;1589;3202;0,503747658;0,496252342
220375;FARTURA DO PIAUI;2685;2645;5330;0,503752345;0,496247655
314240;MOEMA;3823;3766;7589;0,503755435;0,496244565
280470;NOSSA SENHORA DE LOURDES;3279;3230;6509;0,503764019;0,496235981
291995;MAETINGA;1202;1184;2386;0,503772003;0,496227997
210800;PASTOS BONS;9921;9772;19693;0,50378307;0,49621693
430290;CACEQUI;6192;6099;12291;0,503783256;0,496216744
250200;BELEM DO BREJO DO CRUZ;3706;3650;7356;0,503806417;0,496193583
510760;RONDONOPOLIS;120721;118892;239613;0,503816571;0,496183429
500080;ANAURILANDIA;4593;4523;9116;0,503839403;0,496160597
291880;LAJE;12200;12014;24214;0,503840753;0,496159247
316700;SERRANOS;982;967;1949;0,503848127;0,496151873
231200;SANTANA DO ACARAU;16552;16299;32851;0,50385072;0,49614928
293030;SERRA DOURADA;8697;8564;17261;0,503852616;0,496147384
260480;CORTES;6320;6223;12543;0,503866699;0,496133301
410350;CALIFORNIA;4354;4287;8641;0,503876866;0,496123134
292980;SAUDE;6536;6435;12971;0,5038933;0,4961067
220777;PATOS DO PIAUI;3235;3185;6420;0,503894081;0,496105919
522015;SAO LUIZ DO NORTE;2652;2611;5263;0,503895117;0,496104883
313115;IPABA;9537;9389;18926;0,503909965;0,496090035
350420;AURIFLAMA;7718;7598;15316;0,503917472;0,496082528
410470;CARLOPOLIS;7252;7139;14391;0,503926065;0,496073935
313065;INDAIABIRA;3693;3635;7328;0,503957424;0,496042576
250157;BARRA DE SANTANA;4202;4136;8338;0,503957784;0,496042216
291075;FATIMA;8971;8830;17801;0,503960452;0,496039548
421265;PESCARIA BRAVA;5153;5072;10225;0,50396088;0,49603912
421460;RIO DO OESTE;3806;3746;7552;0,503972458;0,496027542
230230;BELA CRUZ;16556;16295;32851;0,503972482;0,496027518
231095;PIRES FERREIRA;5570;5482;11052;0,50398118;0,49601882
352060;INDIANA;2456;2417;4873;0,504001642;0,495998358
355610;VALENTIM GENTIL;6921;6811;13732;0,504005243;0,495994757
521800;PORANGATU;23117;22749;45866;0,504011686;0,495988314
351090;CASSIA DOS COQUEIROS;1254;1234;2488;0,504019293;0,495980707
411250;JARDIM ALEGRE;5578;5489;11067;0,504020963;0,495979037
430537;CHARRUA;1627;1601;3228;0,504027261;0,495972739
521010;IPAMERI;13793;13572;27365;0,504038005;0,495961995
410832;FRANCISCO ALVES;2995;2947;5942;0,504039044;0,495960956
520050;ALOANDIA;996;980;1976;0,504048583;0,495951417
230050;ALCANTARAS;5971;5875;11846;0,504052001;0,495947999
431480;PORTAO;19195;18886;38081;0,504057141;0,495942859
261255;SANTA FILOMENA;7382;7263;14645;0,50406282;0,49593718
150740;SAO FRANCISCO DO PARA;8054;7924;15978;0,504068094;0,495931906
411130;ITAUNA DO SUL;1361;1339;2700;0,504074074;0,495925926
250937;MATO GROSSO;1484;1460;2944;0,504076087;0,495923913
251660;TAVARES;7456;7335;14791;0,504090325;0,495909675
311920;COROACI;4989;4908;9897;0,504092149;0,495907851
312510;EXTREMA;18979;18670;37649;0,504103695;0,495896305
230427;ERERE;3657;3597;7254;0,504135649;0,495864351
261080;PEDRA;11452;11264;22716;0,504138052;0,495861948
421520;ROMELANDIA;2311;2273;4584;0,504144852;0,495855148
510263;CAMPO NOVO DO PARECIS;18612;18305;36917;0,504157976;0,495842024
431700;SANTANA DA BOA VISTA;4052;3985;8037;0,504168222;0,495831778
350730;BORACEIA;2477;2436;4913;0,504172603;0,495827397
316310;SAO JOSE DA VARGINHA;2597;2554;5151;0,504173947;0,495826053
353610;PARDINHO;3317;3262;6579;0,504179967;0,495820033
411910;PIEN;6562;6453;13015;0,504187476;0,495812524
210690;MONCAO;17086;16802;33888;0,504190274;0,495809726
250570;DONA INES;5231;5144;10375;0,504192771;0,495807229
292320;OLIVEIRA DOS BREJINHOS;10990;10807;21797;0,504197825;0,495802175
314650;PAINS;4189;4119;8308;0,504212807;0,495787193
420257;BOM JESUS DO OESTE;1077;1059;2136;0,504213483;0,495786517
291140;GLORIA;7688;7559;15247;0,50423034;0,49576966
411345;LINDOESTE;2263;2225;4488;0,504233512;0,495766488
310445;ARICANDUVA;2675;2630;5305;0,504241282;0,495758718
510100;ARAGUAIANA;1545;1519;3064;0,50424282;0,49575718
310210;ALTO RIO DOCE;5407;5316;10723;0,504243216;0,495756784
412560;SAO MATEUS DO SUL;23769;23368;47137;0,504253559;0,495746441
330440;RIO CLARO;9418;9259;18677;0,504256572;0,495743428
520510;CATALAO;57027;56064;113091;0,504257633;0,495742367
251060;OURO VELHO;1539;1513;3052;0,504259502;0,495740498
312630;FORTALEZA DE MINAS;2249;2211;4460;0,50426009;0,49573991
420945;LAJEADO GRANDE;710;698;1408;0,504261364;0,495738636
410970;IBAITI;16063;15791;31854;0,50426948;0,49573052
220810;PIMENTEIRAS;6127;6023;12150;0,504279835;0,495720165
293105;TANQUE NOVO;8834;8684;17518;0,504281311;0,495718689
150145;BELTERRA;9049;8895;17944;0,504291128;0,495708872
220420;FRANCISCO SANTOS;4752;4671;9423;0,504297994;0,495702006
355680;VIRADOURO;9649;9484;19133;0,504311922;0,495688078
520545;CEZARINA;4435;4359;8794;0,504321128;0,495678872
260330;CALCADO;5539;5444;10983;0,504324866;0,495675134
290810;COCOS;9499;9336;18835;0,504327051;0,495672949
420530;FAXINAL DOS GUEDES;5361;5269;10630;0,504327375;0,495672625
317040;UNAI;43101;42360;85461;0,504335311;0,495664689
350800;BURI;10112;9938;20050;0,504339152;0,495660848
290880;CONTENDAS DO SINCORA;2030;1995;4025;0,504347826;0,495652174
314225;MIRAVANIA;2491;2448;4939;0,504353108;0,495646892
430690;ENCRUZILHADA DO SUL;13133;12906;26039;0,504358846;0,495641154
431920;SAO NICOLAU;2599;2554;5153;0,504366389;0,495633611
421370;POUSO REDONDO;9061;8904;17965;0,504369608;0,495630392
170388;CARMOLANDIA;1325;1302;2627;0,504377617;0,495622383
350670;BOA ESPERANCA DO SUL;7622;7489;15111;0,504400768;0,495599232
220558;LAGOA DO PIAUI;2061;2025;4086;0,504405286;0,495594714
311650;CLARO DOS POCOES;3772;3706;7478;0,504412945;0,495587055
211230;TUNTUM;21308;20934;42242;0,504426874;0,495573126
521060;ITAGUARU;2615;2569;5184;0,504436728;0,495563272
431030;ILOPOLIS;2045;2009;4054;0,504440059;0,495559941
230360;CATARINA;10614;10427;21041;0,504443705;0,495556295
314230;MOEDA;2496;2452;4948;0,504446241;0,495553759
290590;CAMPO ALEGRE DE LOURDES;14548;14291;28839;0,504455772;0,495544228
310390;ARAUJOS;4804;4719;9523;0,504462879;0,495537121
110170;URUPA;5590;5491;11081;0,504467106;0,495532894
421020;MAJOR GERCINO;1748;1717;3465;0,504473304;0,495526696
220450;GUADALUPE;5295;5201;10496;0,504477896;0,495522104
521720;PIRANHAS;5126;5035;10161;0,504477906;0,495522094
430195;BARRA FUNDA;1293;1270;2563;0,504486929;0,495513071
420500;DIONISIO CERQUEIRA;7866;7726;15592;0,504489482;0,495510518
210810;PAULO RAMOS;10641;10451;21092;0,504504077;0,495495923
432285;VESPASIANO CORREA;896;880;1776;0,504504505;0,495495495
352280;ITAPORANGA;7667;7530;15197;0,504507469;0,495492531
250527;CURRAL DE CIMA;2628;2581;5209;0,504511423;0,495488577
251203;POCO DANTAS;1956;1921;3877;0,504513799;0,495486201
432147;TIRADENTES DO SUL;2791;2741;5532;0,504519161;0,495480839
260690;IGUARACY;6188;6077;12265;0,504525071;0,495474929
210170;BARREIRINHAS;32235;31656;63891;0,504531155;0,495468845
431520;PUTINGA;1948;1913;3861;0,504532505;0,495467495
431695;SANTA MARIA DO HERVAL;3220;3162;6382;0,50454403;0,49545597
410700;CURIUVA;7714;7575;15289;0,504545752;0,495454248
510454;ITANHANGA;3547;3483;7030;0,50455192;0,49544808
353750;PEREIRAS;4478;4397;8875;0,50456338;0,49543662
410965;HONORIO SERPA;2538;2492;5030;0,504572565;0,495427435
520015;ADELANDIA;1269;1246;2515;0,504572565;0,495427435
410380;CAMBIRA;4020;3947;7967;0,504581398;0,495418602
313050;ILICINEA;6313;6198;12511;0,504595956;0,495404044
410560;CIDADE GAUCHA;6529;6410;12939;0,504598501;0,495401499
330410;PORCIUNCULA;9622;9446;19068;0,504615062;0,495384938
353660;PAULO DE FARIA;4528;4445;8973;0,504624986;0,495375014
500345;DEODAPOLIS;6582;6461;13043;0,504638503;0,495361497
310520;BANDEIRA;2391;2347;4738;0,504643309;0,495356691
420100;ANITA GARIBALDI;3423;3360;6783;0,504643963;0,495356037
420440;CORONEL FREITAS;4996;4904;9900;0,504646465;0,495353535
431500;PORTO LUCENA;2278;2236;4514;0,504652193;0,495347807
210020;ALCANTARA;11166;10960;22126;0,504655157;0,495344843
520260;AURILANDIA;1514;1486;3000;0,504666667;0,495333333
431848;SAO JOSE DO HORTENCIO;2485;2439;4924;0,504670999;0,495329001
316570;SENADOR FIRMINO;3988;3914;7902;0,504682359;0,495317641
350520;BARIRI;18090;17754;35844;0,504686977;0,495313023
316265;SAO JOAO DO PACUI;2259;2217;4476;0,504691689;0,495308311
251470;SAO JOSE DO SABUGI;2096;2057;4153;0,504695401;0,495304599
520120;ANHANGUERA;591;580;1171;0,50469684;0,49530316
171670;COLMEIA;4077;4001;8078;0,504704135;0,495295865
231090;PIQUET CARNEIRO;8686;8524;17210;0,504706566;0,495293434
411705;NOVA LARANJEIRAS;5785;5677;11462;0,50471122;0,49528878
411010;IMBITUVA;16810;16496;33306;0,504713865;0,495286135
420330;CAMPO ALEGRE;6049;5936;11985;0,504714226;0,495285774
330515;SAO JOSE DO VALE DO RIO PRETO;11120;10912;22032;0,504720407;0,495279593
251180;PIRPIRITUBA;5345;5245;10590;0,504721435;0,495278565
432143;TERRA DE AREIA;5715;5608;11323;0,504724896;0,495275104
312420;ESPERA FELIZ;12763;12524;25287;0,504725748;0,495274252
250330;CACHOEIRA DOS INDIOS;5231;5133;10364;0,504727904;0,495272096
250800;JURU;4962;4869;9831;0,504729936;0,495270064
420690;IBIRAMA;9710;9528;19238;0,504730221;0,495269779
410670;CRUZEIRO DO SUL;2236;2194;4430;0,504740406;0,495259594
293000;SEBASTIAO LARANJEIRAS;5848;5738;11586;0,504747109;0,495252891
240960;PEDRA PRETA;1221;1198;2419;0,504754031;0,495245969
521400;MOZARLANDIA;8115;7962;16077;0,50475835;0,49524165
312460;ESTRELA DALVA;1165;1143;2308;0,504766031;0,495233969
150746;SAO JOAO DA PONTA;3177;3117;6294;0,504766444;0,495233556
210710;MORROS;9948;9760;19708;0,504769637;0,495230363
311540;CATAS ALTAS DA NORUEGA;1850;1815;3665;0,504774898;0,495225102
291915;LAPAO;13792;13531;27323;0,504776196;0,495223804
430087;ARARICA;2948;2892;5840;0,504794521;0,495205479
210830;PENALVA;19681;19306;38987;0,504809295;0,495190705
291940;LICINIO DE ALMEIDA;6238;6119;12357;0,504815085;0,495184915
315960;SANTA RITA DO SAPUCAI;22326;21900;44226;0,504816171;0,495183829
110034;ALVORADA D'OESTE;6970;6837;13807;0,504816397;0,495183603
411320;LAPA;24560;24091;48651;0,504820045;0,495179955
211040;SAO BENEDITO DO RIO PRETO;9475;9294;18769;0,504821781;0,495178219
500240;CAARAPO;15652;15353;31005;0,504821803;0,495178197
210462;GOVERNADOR LUIZ ROCHA;3977;3901;7878;0,504823559;0,495176441
270160;CANAPI;8943;8772;17715;0,504826418;0,495173582
330093;CARAPEBUS;8511;8348;16859;0,504834213;0,495165787
292525;PONTO NOVO;7436;7293;14729;0,504854369;0,495145631
172010;SAO BENTO DO TOCANTINS;2755;2702;5457;0,504856148;0,495143852
431861;SAO JOSE DO SUL;1244;1220;2464;0,50487013;0,49512987
261260;SANTA MARIA DA BOA VISTA;21339;20927;42266;0,504873894;0,495126106
351480;ELDORADO;7872;7720;15592;0,504874295;0,495125705
431477;PONTAO;1968;1930;3898;0,504874295;0,495125705
520570;CORREGO DO OURO;1138;1116;2254;0,504880213;0,495119787
150195;CACHOEIRA DO PIRIA;17826;17481;35307;0,504885717;0,495114283
315100;PIRANGUINHO;4384;4299;8683;0,504894622;0,495105378
350220;ANGATUBA;12988;12736;25724;0,50489815;0,49510185
292270;NOVA CANAA;8322;8160;16482;0,504914452;0,495085548
410090;AMAPORA;3234;3171;6405;0,504918033;0,495081967
431162;LINDOLFO COLLOR;3127;3066;6193;0,504924915;0,495075085
291700;ITIUBA;18248;17892;36140;0,504925291;0,495074709
410870;GRANDES RIOS;2716;2663;5379;0,504926566;0,495073434
313810;LASSANCE;3279;3215;6494;0,504927626;0,495072374
210630;MAGALHAES DE ALMEIDA;10214;10014;20228;0,504943642;0,495056358
317005;UBAPORANGA;6319;6195;12514;0,504954451;0,495045549
431912;SAO MARTINHO DA SERRA;1630;1598;3228;0,504956629;0,495043371
510267;CAMPO VERDE;22235;21798;44033;0,504962187;0,495037813
251570;SERRA GRANDE;1475;1446;2921;0,504964053;0,495035947
270780;ROTEIRO;3350;3284;6634;0,504974374;0,495025626
260360;CAMUTANGA;4339;4253;8592;0,505004655;0,494995345
240933;SANTA MARIA;2873;2816;5689;0,505009668;0,494990332
312470;ESTRELA DO INDAIA;1759;1724;3483;0,505024404;0,494975596
412050;PRIMEIRO DE MAIO;5625;5513;11138;0,505027833;0,494972167
412030;PORTO VITORIA;2049;2008;4057;0,505052995;0,494947005
430469;CAPITAO;1399;1371;2770;0,505054152;0,494945848
210667;MILAGRES DO MARANHAO;4294;4208;8502;0,505057633;0,494942367
421825;TIMBO GRANDE;4042;3961;8003;0,505060602;0,494939398
353670;PEDERNEIRAS;24002;23521;47523;0,505060707;0,494939293
411170;JABOTI;2693;2639;5332;0,505063766;0,494936234
230395;CHOROZINHO;10246;10040;20286;0,505077393;0,494922607
421755;SERRA ALTA;1641;1608;3249;0,505078486;0,494921514
432380;XANGRI-LA;8650;8476;17126;0,505079995;0,494920005
220555;LAGOA ALEGRE;4349;4261;8610;0,505110337;0,494889663
320030;ALFREDO CHAVES;7410;7260;14670;0,505112474;0,494887526
431053;ITAARA;2815;2758;5573;0,505113942;0,494886058
240380;FLORANIA;4936;4836;9772;0,50511666;0,49488334
240860;PARANA;2171;2127;4298;0,50511866;0,49488134
171150;JAU DO TOCANTINS;1973;1933;3906;0,505120328;0,494879672
312400;ERVALIA;9607;9412;19019;0,505126452;0,494873548
230720;JATI;4117;4033;8150;0,505153374;0,494846626
421420;QUILOMBO;4937;4836;9773;0,505167298;0,494832702
412160;RENASCENCA;3421;3351;6772;0,50516834;0,49483166
354450;RUBINEIA;1612;1579;3191;0,505170793;0,494829207
312010;COUTO DE MAGALHAES DE MINAS;2241;2195;4436;0,505184851;0,494815149
315190;POCRANE;4187;4101;8288;0,505188224;0,494811776
430185;BARRA DO GUARITA;1650;1616;3266;0,505205144;0,494794856
420450;CORUPA;8235;8065;16300;0,505214724;0,494785276
320430;PRESIDENTE KENNEDY;5932;5809;11741;0,505238055;0,494761945
170700;DIANOPOLIS;11471;11233;22704;0,505241367;0,494758633
320410;PINHEIROS;13946;13655;27601;0,505271548;0,494728452
520393;BURITI DE GOIAS;1245;1219;2464;0,505275974;0,494724026
314180;MINAS NOVAS;15921;15588;31509;0,505284205;0,494715795
230090;APUIARES;7449;7293;14742;0,505291005;0,494708995
420350;CAMPO ERE;4200;4112;8312;0,505293551;0,494706449
310930;BURITIS;12723;12456;25179;0,505302037;0,494697963
330560;SILVA JARDIM;11003;10772;21775;0,505304248;0,494695752
150010;ABAETETUBA;81073;79366;160439;0,505319779;0,494680221
280420;MONTE ALEGRE DE SERGIPE;7739;7576;15315;0,50532158;0,49467842
220345;DOM INOCENCIO;4838;4736;9574;0,505326927;0,494673073
521270;MAMBAI;4688;4589;9277;0,505335777;0,494664223
420415;CELSO RAMOS;1369;1340;2709;0,505352529;0,494647471
311600;CHALE;2878;2817;5695;0,505355575;0,494644425
420195;BALNEARIO ARROIO DO SILVA;6965;6817;13782;0,505369322;0,494630678
130255;MANAQUIRI;17173;16808;33981;0,505370648;0,494629352
210043;ALTO ALEGRE DO MARANHAO;14184;13882;28066;0,505380175;0,494619825
230650;ITAPIUNA;10438;10215;20653;0,505398731;0,494601269
411125;ITAPERUCU;14906;14587;29493;0,505408063;0,494591937
351100;CASTILHO;10877;10644;21521;0,505413317;0,494586683
412380;SANTA IZABEL DO OESTE;7543;7381;14924;0,505427499;0,494572501
352170;ITABERA;8797;8608;17405;0,505429474;0,494570526
355470;TORRINHA;5105;4995;10100;0,505445545;0,494554455
350660;BIRITIBA-MIRIM;16814;16451;33265;0,505456185;0,494543815
520460;CAMPESTRE DE GOIAS;1851;1811;3662;0,505461496;0,494538504
420253;BOM JESUS;1569;1535;3104;0,505476804;0,494523196
220160;BENEDITINOS;5297;5182;10479;0,505487165;0,494512835
220855;PORTO ALEGRE DO PIAUI;1379;1349;2728;0,505498534;0,494501466
520980;HIDROLINA;1744;1706;3450;0,505507246;0,494492754
351410;DOIS CORREGOS;14005;13699;27704;0,505522668;0,494477332
420880;JAGUARUNA;10387;10160;20547;0,505523921;0,494476079
240390;FRANCISCO DANTAS;1416;1385;2801;0,505533738;0,494466262
292593;QUIXABEIRA;4519;4420;8939;0,505537532;0,494462468
430905;GLORINHA;4198;4106;8304;0,505539499;0,494460501
170070;ALVORADA;4237;4144;8381;0,505548264;0,494451736
240540;JAPI;2495;2440;4935;0,505572442;0,494427558
251276;RIACHAO DO POCO;2311;2260;4571;0,505578648;0,494421352
316330;SAO JOSE DO DIVINO;1947;1904;3851;0,505582965;0,494417035
521870;RIANAPOLIS;2443;2389;4832;0,505587748;0,494412252
353140;MONTE APRAZIVEL;12969;12682;25651;0,505594324;0,494405676
431046;IPIRANGA DO SUL;946;925;1871;0,505611972;0,494388028
410855;GODOY MOREIRA;1441;1409;2850;0,505614035;0,494385965
430090;ARATIBA;3107;3038;6145;0,505614321;0,494385679
411920;PINHALAO;3197;3126;6323;0,505614424;0,494385576
430435;CANDIOTA;4908;4799;9707;0,505614505;0,494385495
261400;SERRITA;9721;9505;19226;0,505617393;0,494382607
311710;CONCEICAO DA APARECIDA;5234;5117;10351;0,505651628;0,494348372
150745;SAO GERALDO DO ARAGUAIA;12422;12144;24566;0,505658227;0,494341773
240680;LAJES PINTADAS;2411;2357;4768;0,505662752;0,494337248
510740;SAO PEDRO DA CIPA;2439;2384;4823;0,505701845;0,494298155
431244;MORRINHOS DO SUL;1462;1429;2891;0,505707368;0,494292632
292150;MONTE SANTO;24854;24291;49145;0,505727948;0,494272052
411080;IRETAMA;5072;4957;10029;0,505733373;0,494266627
240145;BARAUNA;14723;14389;29112;0,505736466;0,494263534
315310;PRESIDENTE BERNARDES;2688;2627;5315;0,505738476;0,494261524
280260;GRACHO CARDOSO;2949;2882;5831;0,505745155;0,494254845
350700;BOITUVA;32019;31291;63310;0,505749487;0,494250513
170035;ALIANCA DO TOCANTINS;2682;2621;5303;0,505751461;0,494248539
412150;REBOUCAS;7582;7409;14991;0,505770129;0,494229871
291930;LENCOIS;5860;5726;11586;0,505782841;0,494217159
290930;CORRENTINA;16308;15935;32243;0,505784201;0,494215799
314720;PARAGUACU;10972;10721;21693;0,505785276;0,494214724
352510;JARDINOPOLIS;23036;22508;45544;0,505796592;0,494203408
410895;GUAMIRANGA;4492;4389;8881;0,505798897;0,494201103
260590;GAMELEIRA;15973;15605;31578;0,505826841;0,494173159
270250;DOIS RIACHOS;5594;5465;11059;0,505832354;0,494167646
354170;QUATA;7238;7071;14309;0,505835488;0,494164512
130250;MANACAPURU;50388;49225;99613;0,505837591;0,494162409
352020;IGARATA;4872;4759;9631;0,505866473;0,494133527
522068;SIMOLANDIA;3488;3407;6895;0,505873822;0,494126178
150549;PALESTINA DO PARA;3832;3743;7575;0,505874587;0,494125413
315930;SANTA RITA DE JACUTINGA;2450;2393;4843;0,505884782;0,494115218
521460;NIQUELANDIA;23809;23255;47064;0,505885603;0,494114397
230610;IRAUCUBA;12369;12081;24450;0,505889571;0,494110429
351270;CORUMBATAI;2060;2012;4072;0,50589391;0,49410609
412580;SAO PEDRO DO IVAI;5620;5489;11109;0,50589612;0,49410388
292575;PRESIDENTE TANCREDO NEVES;14303;13969;28272;0,505906904;0,494093096
230470;GRANJA;27911;27259;55170;0,505909009;0,494090991
316060;SANTO HIPOLITO;1540;1504;3044;0,505913272;0,494086728
330380;PARATY;22349;21826;44175;0,505919638;0,494080362
230945;OCARA;13133;12825;25958;0,50593266;0,49406734
521100;ITAPIRAPUA;2216;2164;4380;0,505936073;0,494063927
316780;SOLEDADE DE MINAS;3150;3076;6226;0,50594282;0,49405718
240160;BENTO FERNANDES;2809;2743;5552;0,505943804;0,494056196
250407;CARAUBAS;2128;2078;4206;0,50594389;0,49405611
311580;CENTRALINA;5233;5110;10343;0,50594605;0,49405395
110014;NOVA BRASILANDIA D'OESTE;10374;10130;20504;0,505950059;0,494049941
293120;TAPEROA;10838;10583;21421;0,505952103;0,494047897
510455;ITAUBA;1826;1783;3609;0,505957329;0,494042671
421160;NOVA VENEZA;7850;7665;15515;0,505961972;0,494038028
352120;IPORANGA;2115;2065;4180;0,505980861;0,494019139
230150;ARNEIROZ;3971;3877;7848;0,505988787;0,494011213
210070;ANAJATUBA;13748;13422;27170;0,505999264;0,494000736
420750;INDAIAL;36608;35738;72346;0,506012772;0,493987228
320350;MONTANHA;9591;9363;18954;0,506014562;0,493985438
421230;PAULO LOPES;3867;3775;7642;0,506019367;0,493980633
291770;JAGUARARI;17162;16753;33915;0,50602978;0,49397022
293240;UIBAI;7031;6863;13894;0,506045775;0,493954225
420260;BOM RETIRO;5138;5015;10153;0,506057323;0,493942677
430430;CANDIDO GODOI;3090;3016;6106;0,506059613;0,493940387
430720;ERVAL GRANDE;2419;2361;4780;0,506066946;0,493933054
210700;MONTES ALTOS;4587;4477;9064;0,506067961;0,493932039
410070;ALTO PIQUIRI;4920;4802;9722;0,50606871;0,49393129
420127;ARABUTA;2160;2108;4268;0,506091846;0,493908154
291580;ITAMBE;11374;11100;22474;0,506095933;0,493904067
170380;BURITI DO TOCANTINS;5893;5751;11644;0,506097561;0,493902439
291520;ITAGIBA;7253;7078;14331;0,506105645;0,493894355
280390;MALHADOR;6422;6267;12689;0,506107652;0,493892348
521920;SANTA CRUZ DE GOIAS;1408;1374;2782;0,506110712;0,493889288
316970;TURMALINA;10264;10016;20280;0,506114398;0,493885602
150620;SALINOPOLIS;20834;20330;41164;0,506121854;0,493878146
410770;FENIX;2396;2338;4734;0,506125898;0,493874102
150230;CAPITAO POCO;27607;26938;54545;0,506132551;0,493867449
210680;MIRINZAL;7622;7437;15059;0,506142506;0,493857494
411000;IGUARACU;2265;2210;4475;0,506145251;0,493854749
520960;HEITORAI;1894;1848;3742;0,506146446;0,493853554
290265;BANZAE;6707;6544;13251;0,506150479;0,493849521
430005;AGUA SANTA;1892;1846;3738;0,506153023;0,493846977
410750;ENGENHEIRO BELTRAO;7067;6895;13962;0,506159576;0,493840424
521570;PALMEIRAS DE GOIAS;15142;14773;29915;0,506167475;0,493832525
270370;JARAMATAIA;2911;2840;5751;0,50617284;0,49382716
314050;MARTINHO CAMPOS;6832;6665;13497;0,50618656;0,49381344
421940;WITMARSUM;2041;1991;4032;0,506200397;0,493799603
251460;SAO JOSE DO BONFIM;1832;1787;3619;0,506217187;0,493782813
510718;RIBEIRAO CASCALHEIRA;5290;5160;10450;0,506220096;0,493779904
290180;ANTONIO GONCALVES;6052;5903;11955;0,506231702;0,493768298
411780;PALMITAL;6457;6298;12755;0,50623285;0,49376715
313250;ITAMARANDIBA;17784;17346;35130;0,506233988;0,493766012
170220;ARAGUATINS;18515;18058;36573;0,506247778;0,493752222
316950;TUMIRITINGA;3441;3356;6797;0,506252759;0,493747241
430165;BARAO;3155;3077;6232;0,506258023;0,493741977
110080;CANDEIAS DO JAMARI;14210;13858;28068;0,506270486;0,493729514
500020;AGUA CLARA;8113;7912;16025;0,506271451;0,493728549
210290;CARUTAPERA;12199;11896;24095;0,506287612;0,493712388
320270;ITAGUACU;7079;6903;13982;0,506293806;0,493706194
431413;PAULO BENTO;1166;1137;2303;0,506296135;0,493703865
352370;ITIRAPUA;3335;3252;6587;0,506300288;0,493699712
314830;PAULA CANDIDO;4859;4738;9597;0,506304053;0,493695947
430781;ESTRELA VELHA;1846;1800;3646;0,506308283;0,493691717
421510;RODEIO;5897;5750;11647;0,506310638;0,493689362
290080;ALCOBACA;11397;11112;22509;0,506330801;0,493669199
315330;PRESIDENTE KUBITSCHEK;1519;1481;3000;0,506333333;0,493666667
311510;CASSIA;8983;8758;17741;0,506341243;0,493658757
240030;AFONSO BEZERRA;5582;5442;11024;0,506349782;0,493650218
210235;BURITIRANA;7850;7653;15503;0,506353609;0,493646391
355290;TACIBA;3226;3145;6371;0,50635693;0,49364307
171430;NAZARE;1910;1862;3772;0,506362672;0,493637328
312830;GUARANESIA;9628;9386;19014;0,506363732;0,493636268
261420;SIRINHAEM;23721;23124;46845;0,506372078;0,493627922
220211;CAMPO ALEGRE DO FIDALGO;2579;2514;5093;0,506381308;0,493618692
431390;PANAMBI;22576;22007;44583;0,506381356;0,493618644
410304;BOA VENTURA DE SAO ROQUE;3212;3131;6343;0,506384991;0,493615009
430230;BOM JESUS;5707;5563;11270;0,506388642;0,493611358
421223;PARAISO;1663;1621;3284;0,506394641;0,493605359
290610;CANAPOLIS;4909;4785;9694;0,506395709;0,493604291
220250;CARACOL;5575;5434;11009;0,506403851;0,493596149
251385;SANTO ANDRE;1264;1232;2496;0,506410256;0,493589744
110010;GUAJARA-MIRIM;23766;23164;46930;0,506413808;0,493586192
430880;GENERAL CAMARA;4223;4116;8339;0,506415637;0,493584363
411970;PLANALTINA DO PARANA;2168;2113;4281;0,506423733;0,493576267
290323;BARRO ALTO;7683;7488;15171;0,506426735;0,493573265
150635;SANTA BARBARA DO PARA;11046;10765;21811;0,506441704;0,493558296
431179;MARATA;1374;1339;2713;0,506450424;0,493549576
430620;CRUZEIRO DO SUL;6309;6148;12457;0,50646223;0,49353777
230535;ICAPUI;10222;9961;20183;0,506465838;0,493534162
354370;RINCAO;5482;5342;10824;0,50646711;0,49353289
311783;CONEGO MARINHO;3915;3815;7730;0,506468305;0,493531695
351512;EMILIANOPOLIS;1640;1598;3238;0,506485485;0,493514515
430975;IBARAMA;2225;2168;4393;0,506487594;0,493512406
290720;CASA NOVA;37021;36071;73092;0,506498659;0,493501341
520030;ALEXANIA;14365;13995;28360;0,506523272;0,493476728
314270;MONTALVANIA;7406;7215;14621;0,506531701;0,493468299
292590;QUIJINGUE;14017;13655;27672;0,506540908;0,493459092
420040;AGUA DOCE;3627;3533;7160;0,506564246;0,493435754
210047;ALTO ALEGRE DO PINDARE;16194;15773;31967;0,506584916;0,493415084
230020;ACARAU;32197;31359;63556;0,506592611;0,493407389
313330;ITAOBIM;10637;10360;20997;0,50659618;0,49340382
354995;SAO LOURENCO DA SERRA;8170;7957;16127;0,506603832;0,493396168
420770;IPUMIRIM;3874;3773;7647;0,506603897;0,493396103
430807;FAZENDA VILANOVA;2371;2309;4680;0,506623932;0,493376068
250905;MARCACAO;4431;4315;8746;0,506631603;0,493368397
432340;VILA MARIA;2213;2155;4368;0,506639194;0,493360806
421380;PRAIA GRANDE;3701;3604;7305;0,506639288;0,493360712
500770;SETE QUEDAS;5447;5304;10751;0,506650544;0,493349456
420370;CANELINHA;6360;6193;12553;0,506651796;0,493348204
317057;VARGEM ALEGRE;3273;3187;6460;0,506656347;0,493343653
280050;AREIA BRANCA;9538;9287;18825;0,506666667;0,493333333
251455;SAO JOSE DE PRINCESA;1975;1923;3898;0,506670087;0,493329913
316790;TABULEIRO;1859;1810;3669;0,506677569;0,493322431
280280;INDIAROBA;9291;9046;18337;0,506680482;0,493319518
354060;PORTO FELIZ;27208;26490;53698;0,506685538;0,493314462
353790;PILAR DO SUL;15004;14608;29612;0,506686478;0,493313522
432032;SENADOR SALGADO FILHO;1399;1362;2761;0,506700471;0,493299529
313660;NOVA UNIAO;2908;2831;5739;0,506708486;0,493291514
292280;NOVA ITARANA;4220;4108;8328;0,506724304;0,493275696
500730;RIO NEGRO;2411;2347;4758;0,506725515;0,493274485
412260;RONDON;4897;4767;9664;0,506725993;0,493274007
290327;BARROCAS;8222;8003;16225;0,506748844;0,493251156
521730;PIRENOPOLIS;12780;12438;25218;0,506780871;0,493219129
521370;MONTES CLAROS DE GOIAS;4073;3964;8037;0,506781137;0,493218863
313500;JAGUARACU;1597;1554;3151;0,506823231;0,493176769
522160;URUACU;20856;20294;41150;0,506828676;0,493171324
430865;GARRUCHOS;1445;1406;2851;0,506839705;0,493160295
290020;ABARE;10438;10156;20594;0,506846654;0,493153346
330230;LAJE DO MURIAE;3699;3599;7298;0,506851192;0,493148808
220225;CANAVIEIRA;1996;1942;3938;0,506856272;0,493143728
500440;INOCENCIA;3835;3731;7566;0,506872852;0,493127148
411007;IMBAU;6817;6632;13449;0,506877835;0,493122165
250115;AREIA DE BARAUNAS;1067;1038;2105;0,506888361;0,493111639
330540;SAPUCAIA;9261;9009;18270;0,506896552;0,493103448
312380;ENGENHEIRO NAVARRO;3670;3570;7240;0,506906077;0,493093923
260180;BETANIA;6494;6317;12811;0,506908126;0,493091874
311460;CARRANCAS;2054;1998;4052;0,506910168;0,493089832
220669;MURICI DOS PORTELAS;4693;4565;9258;0,50691294;0,49308706
220273;COIVARAS;2050;1994;4044;0,506923838;0,493076162
220545;JOCA MARQUES;2782;2706;5488;0,506924198;0,493075802
316935;TRES MARIAS;16760;16302;33062;0,506926381;0,493073619
312087;CURRAL DE DENTRO;3988;3879;7867;0,506927673;0,493072327
171830;PRAIA NORTE;4341;4222;8563;0,506948499;0,493051501
353990;POLONI;3126;3040;6166;0,506973727;0,493026273
314150;MENDES PIMENTEL;3268;3178;6446;0,506981074;0,493018926
510625;NOVA XAVANTINA;10999;10696;21695;0,506983176;0,493016824
250010;AGUA BRANCA;5260;5115;10375;0,506987952;0,493012048
280650;SANTA ROSA DE LIMA;1994;1939;3933;0,506992118;0,493007882
292925;SAO GABRIEL;9524;9261;18785;0,507000266;0,492999734
220540;JOAQUIM PIRES;7299;7097;14396;0,507015838;0,492984162
241240;SAO JOSE DO SERIDO;2381;2315;4696;0,507027257;0,492972743
353900;PIRANGI;5843;5681;11524;0,507028809;0,492971191
430066;ANDRE DA ROCHA;685;666;1351;0,507031828;0,492968172
351860;GUARIBA;20716;20141;40857;0,507036738;0,492963262
420543;FORMOSA DO SUL;1258;1223;2481;0,507053607;0,492946393
500790;SIDROLANDIA;30825;29967;60792;0,50705685;0,49294315
314400;MUTUM;13663;13282;26945;0,507069957;0,492930043
250560;DIAMANTE;3299;3207;6506;0,507070397;0,492929603
211023;SANTANA DO MARANHAO;6949;6755;13704;0,507078225;0,492921775
410715;DIAMANTE D'OESTE;2677;2602;5279;0,507103618;0,492896382
150480;MONTE ALEGRE;29559;28730;58289;0,507111119;0,492888881
320380;MUQUI;7912;7690;15602;0,507114473;0,492885527
171370;MONTE SANTO DO TOCANTINS;1172;1139;2311;0,507139766;0,492860234
312210;DIVINO DAS LARANJEIRAS;2520;2449;4969;0,507144295;0,492855705
521280;MARA ROSA;4683;4551;9234;0,507147498;0,492852502
510637;PEDRA PRETA;8899;8648;17547;0,50715222;0,49284778
311430;CARMO DO PARANAIBA;15387;14952;30339;0,50716899;0,49283101
171800;PORTO ALEGRE DO TOCANTINS;1623;1577;3200;0,5071875;0,4928125
211190;SUCUPIRA DO NORTE;5392;5239;10631;0,507195936;0,492804064
510560;MATUPA;8631;8386;17017;0,507198684;0,492801316
313570;JEQUITIBA;2639;2564;5203;0,50720738;0,49279262
241142;SANTANA DO SERIDO;1369;1330;2699;0,507224898;0,492775102
291590;ITANAGRA;3263;3170;6433;0,507228354;0,492771646
411090;ITAGUAJE;2245;2181;4426;0,507230005;0,492769995
110147;PRIMAVERA DE RONDONIA;1368;1329;2697;0,507230256;0,492769744
270720;POCO DAS TRINCHEIRAS;7328;7119;14447;0,507233336;0,492766664
250210;BOA VENTURA;2662;2586;5248;0,507240854;0,492759146
500780;SELVIRIA;3325;3230;6555;0,507246377;0,492753623
330200;ITAGUAI;69263;67284;136547;0,507246589;0,492753411
210730;NOVA IORQUE;2375;2307;4682;0,507261854;0,492738146
210592;LAGOA DO MATO;5722;5558;11280;0,507269504;0,492730496
352190;ITAJOBI;7777;7554;15331;0,507272846;0,492727154
431510;PORTO XAVIER;5146;4998;10144;0,507294953;0,492705047
292440;PILAO ARCADO;17905;17390;35295;0,507295651;0,492704349
420535;FLOR DO SERTAO;799;776;1575;0,507301587;0,492698413
316110;SAO FRANCISCO;28726;27899;56625;0,507302428;0,492697572
211107;SAO JOAO DO SOTER;9510;9236;18746;0,507308226;0,492691774
351750;GUAPIACU;11205;10882;22087;0,507311993;0,492688007
510330;COMODORO;10780;10469;21249;0,507317991;0,492682009
110032;SAO MIGUEL DO GUAPORE;11743;11404;23147;0,507322763;0,492677237
411005;IGUATU;1142;1109;2251;0,507330076;0,492669924
172065;SILVANOPOLIS;2766;2686;5452;0,507336757;0,492663243
312200;DIVINO;10157;9863;20020;0,507342657;0,492657343
171200;LAJEADO;1623;1576;3199;0,507346046;0,492653954
410045;ALTAMIRA DO PARANA;725;704;1429;0,507347796;0,492652204
310080;AGUANIL;2312;2245;4557;0,507351328;0,492648672
351015;CANITAR;2722;2643;5365;0,507362535;0,492637465
352450;JACI;3715;3607;7322;0,507375034;0,492624966
521520;NOVO BRASIL;1408;1367;2775;0,507387387;0,492612613
351970;IBIUNA;40623;39439;80062;0,507394269;0,492605731
220265;CAXINGO;2779;2698;5477;0,507394559;0,492605441
311160;CAMPOS GERAIS;14668;14240;28908;0,507402795;0,492597205
172025;SAO SALVADOR DO TOCANTINS;1576;1530;3106;0,507405023;0,492594977
430340;CAICARA;2364;2295;4659;0,507405023;0,492594977
316380;SAO MIGUEL DO ANTA;3526;3423;6949;0,507411138;0,492588862
521170;JANDAIA;3045;2956;6001;0,507415431;0,492584569
351760;GUAPIARA;8574;8322;16896;0,507457386;0,492542614
220570;LUIS CORREIA;15507;15051;30558;0,507461221;0,492538779
412795;TUPASSI;4113;3992;8105;0,507464528;0,492535472
412785;TRES BARRAS DO PARANA;6108;5928;12036;0,507477567;0,492522433
430635;DEZESSEIS DE NOVEMBRO;1183;1148;2331;0,507507508;0,492492492
251315;SANTA CECILIA;3312;3214;6526;0,507508428;0,492491572
314200;MIRABELA;6928;6723;13651;0,507508607;0,492491393
291600;ITANHEM;9760;9471;19231;0,50751391;0,49248609
315060;PIRACEMA;3241;3145;6386;0,507516442;0,492483558
431333;NOVA RAMADA;1114;1081;2195;0,507517084;0,492482916
520340;BOM JARDIM DE GOIAS;4523;4389;8912;0,507517953;0,492482047
420125;APIUNA;5558;5393;10951;0,507533559;0,492466441
430237;BOM PROGRESSO;943;915;1858;0,507534984;0,492465016
430840;FORMIGUEIRO;3334;3235;6569;0,507535394;0,492464606
410754;ESPIGAO ALTO DO IGUACU;2020;1960;3980;0,507537688;0,492462312
500320;CORUMBA;57184;55485;112669;0,507539785;0,492460215
150330;IGARAPE-MIRI;32162;31205;63367;0,507551249;0,492448751
520810;FORMOSO;2080;2018;4098;0,507564666;0,492435334
314910;PEDRALVA;5633;5465;11098;0,507568931;0,492431069
313535;JAPONVAR;4056;3935;7991;0,507571017;0,492428983
313300;ITAMONTE;8042;7802;15844;0,507573845;0,492426155
291660;ITAPITANGA;5220;5064;10284;0,507584597;0,492415403
421105;MONTE CARLO;5048;4897;9945;0,507591755;0,492408245
350180;AMERICO DE CAMPOS;3042;2951;5993;0,507592191;0,492407809
313550;JEQUERI;6216;6030;12246;0,507594317;0,492405683
353350;NOVO HORIZONTE;21200;20565;41765;0,507602059;0,492397941
411640;NOSSA SENHORA DAS GRACAS;2035;1974;4009;0,507607882;0,492392118
352220;ITAPECERICA DA SERRA;91154;88420;179574;0,507612461;0,492387539
431112;JAQUIRANA;1833;1778;3611;0,507615619;0,492384381
120043;SANTA ROSA DO PURUS;3499;3394;6893;0,507616422;0,492383578
520840;GOIANAPOLIS;5694;5523;11217;0,507622359;0,492377641
291790;JANDAIRA;5453;5289;10742;0,507633588;0,492366412
412217;RIO BRANCO DO IVAI;2092;2029;4121;0,507643776;0,492356224
522020;SAO MIGUEL DO ARAGUAIA;11092;10757;21849;0,507666255;0,492333745
410080;ALVORADA DO SUL;5888;5710;11598;0,507673737;0,492326263
241380;TABOLEIRO GRANDE;1323;1283;2606;0,507674597;0,492325403
211260;URBANO SANTOS;17155;16636;33791;0,50767956;0,49232044
240550;JARDIM DE ANGICOS;1320;1280;2600;0,507692308;0,492307692
313440;ITURAMA;20359;19742;40101;0,507693075;0,492306925
150360;ITAITUBA;51552;49989;101541;0,507696398;0,492303602
432166;TRES CACHOEIRAS;5673;5501;11174;0,507696438;0,492303562
120033;MANCIO LIMA;9973;9670;19643;0,507712671;0,492287329
290530;CAFARNAUM;9436;9149;18585;0,507721281;0,492278719
220660;MONTE ALEGRE DO PIAUI;5391;5227;10618;0,507722735;0,492277265
270190;CHA PRETA;3712;3599;7311;0,507728081;0,492271919
421150;NOVA TRENTO;7621;7389;15010;0,507728181;0,492271819
510260;CAMPINAPOLIS;8237;7986;16223;0,50773593;0,49226407
354400;RIO DAS PEDRAS;18397;17836;36233;0,507741562;0,492258438
316980;TURVOLANDIA;2589;2510;5099;0,507746617;0,492253383
354860;SAO BENTO DO SAPUCAI;5538;5369;10907;0,507747318;0,492252682
290710;CARINHANHA;14785;14333;29118;0,507761522;0,492238478
210950;RIACHAO;10302;9986;20288;0,507787855;0,492212145
310990;CAETANOPOLIS;6027;5842;11869;0,507793411;0,492206589
353770;PIACATU;3094;2999;6093;0,507795831;0,492204169
310890;BRAZOPOLIS;7294;7070;14364;0,507797271;0,492202729
354460;SABINO;2863;2775;5638;0,507804186;0,492195814
420650;GUARAMIRIM;23744;23013;46757;0,507817011;0,492182989
292335;OUROLANDIA;8921;8646;17567;0,507827176;0,492172824
170200;ARAGUACU;4275;4143;8418;0,507840342;0,492159658
421300;PINHEIRO PRETO;1846;1789;3635;0,50784044;0,49215956
432377;WESTFALIA;1547;1499;3046;0,507879186;0,492120814
520993;INACIOLANDIA;3187;3088;6275;0,507888446;0,492111554
140010;BOA VISTA;221742;214849;436591;0,507894116;0,492105884
240150;BARCELONA;2026;1963;3989;0,507896716;0,492103284
430645;DOIS LAJEADOS;1732;1678;3410;0,507917889;0,492082111
280490;PACATUBA;7441;7209;14650;0,507918089;0,492081911
314890;PEDRA DO INDAIA;2020;1957;3977;0,507920543;0,492079457
410810;FLORIDA;1376;1333;2709;0,507936508;0,492063492
354380;RINOPOLIS;5049;4891;9940;0,507947686;0,492052314
421610;SAO DOMINGOS;4786;4636;9422;0,507960093;0,492039907
311740;CONCEICAO DE IPANEMA;2327;2254;4581;0,507967693;0,492032307
354230;REDENCAO DA SERRA;1944;1883;3827;0,507969689;0,492030311
150270;CONCEICAO DO ARAGUAIA;24441;23674;48115;0,507970487;0,492029513
510805;TERRA NOVA DO NORTE;4716;4568;9284;0,507970702;0,492029298
314053;MARTINS SOARES;4389;4251;8640;0,507986111;0,492013889
354050;PORANGABA;5184;5021;10205;0,507986281;0,492013719
411727;NOVA TEBAS;2668;2584;5252;0,507996954;0,492003046
240630;LAGOA DE PEDRAS;3873;3751;7624;0,508001049;0,491998951
260370;CANHOTINHO;12570;12173;24743;0,508022471;0,491977529
420630;GUABIRUBA;12661;12261;24922;0,508025038;0,491974962
291410;IPUPIARA;5057;4897;9954;0,50803697;0,49196303
421225;PASSO DE TORRES;4709;4560;9269;0,508037545;0,491962455
312020;CRISTAIS;6635;6425;13060;0,508039816;0,491960184
240640;LAGOA DE VELHOS;1388;1344;2732;0,508052709;0,491947291
522190;VARJAO;1955;1893;3848;0,508056133;0,491943867
430697;EREBANGO;1513;1465;2978;0,5080591;0,4919409
311670;COIMBRA;3877;3754;7631;0,508059232;0,491940768
317220;WENCESLAU BRAZ;1292;1251;2543;0,508061345;0,491938655
351360;CUNHA;10859;10514;21373;0,508070931;0,491929069
315080;PIRANGA;8963;8678;17641;0,508077773;0,491922227
411860;PAULA FREITAS;3019;2923;5942;0,508078088;0,491921912
130190;ITACOATIARA;52864;51182;104046;0,508082963;0,491917037
310530;BANDEIRA DO SUL;2951;2857;5808;0,508092287;0,491907713
421795;TIGRINHOS;816;790;1606;0,508094645;0,491905355
432085;TABAI;2447;2369;4816;0,508098007;0,491901993
310830;BORDA DA MATA;10065;9744;19809;0,508102378;0,491897622
220198;BREJO DO PIAUI;1943;1881;3824;0,508106695;0,491893305
421040;MARACAJA;3791;3670;7461;0,508108833;0,491891167
430520;CERRO LARGO;7237;7006;14243;0,508109247;0,491890753
412790;TUNEIRAS DO OESTE;4320;4182;8502;0,508115737;0,491884263
320265;IRUPI;6947;6725;13672;0,508118783;0,491881217
310140;ALBERTINA;1532;1483;3015;0,508126036;0,491873964
315640;ROMARIA;1782;1725;3507;0,508126604;0,491873396
251050;OLIVEDOS;2027;1962;3989;0,508147405;0,491852595
522119;TEREZOPOLIS DE GOIAS;4231;4095;8326;0,508167187;0,491832813
355395;TARUMA;7806;7555;15361;0,508170041;0,491829959
431290;NOVA BASSANO;5127;4962;10089;0,508177223;0,491822777
314820;PATROCINIO DO MURIAE;2919;2825;5744;0,508182451;0,491817549
422000;BALNEARIO RINCAO;6672;6457;13129;0,508187981;0,491812019
431210;MATA;2419;2341;4760;0,508193277;0,491806723
241040;PUREZA;4993;4832;9825;0,508193384;0,491806616
172125;TUPIRAMA;992;960;1952;0,508196721;0,491803279
353630;PATROCINIO PAULISTA;7593;7348;14941;0,508198916;0,491801084
171886;SANTA FE DO ARAGUAIA;3902;3776;7678;0,508205262;0,491794738
311810;CONGONHAS DO NORTE;2565;2482;5047;0,508222707;0,491777293
314620;OURO VERDE DE MINAS;2996;2899;5895;0,508227311;0,491772689
314587;ORIZANIA;4136;4002;8138;0,508232981;0,491767019
220196;BRASILEIRA;4251;4113;8364;0,508249641;0,491750359
210420;FORTUNA;9053;8759;17812;0,508252863;0,491747137
420840;ITAPIRANGA;8711;8428;17139;0,508256024;0,491743976
411590;MIRADOR;1108;1072;2180;0,508256881;0,491743119
311380;CARMESIA;1352;1308;2660;0,508270677;0,491729323
351210;COLOMBIA;3163;3060;6223;0,508275751;0,491724249
220665;MORRO CABECA NO TEMPO;2301;2226;4527;0,508283632;0,491716368
431630;ROQUE GONZALES;3431;3319;6750;0,508296296;0,491703704
500710;RIBAS DO RIO PARDO;12865;12445;25310;0,508297116;0,491702884
251065;PARARI;888;859;1747;0,508299943;0,491700057
431930;SAO PAULO DAS MISSOES;2874;2780;5654;0,508312699;0,491687301
290060;AIQUARA;2230;2157;4387;0,508320036;0,491679964
353420;ORINDIUVA;3720;3598;7318;0,508335611;0,491664389
431115;JOIA;4357;4214;8571;0,508342084;0,491657916
351040;CAPIVARI;28962;28011;56973;0,508346059;0,491653941
290690;CARAVELAS;11268;10898;22166;0,508346116;0,491653884
430955;HARMONIA;2525;2442;4967;0,508355144;0,491644856
240130;AUGUSTO SEVERO;4924;4762;9686;0,508362585;0,491637415
353090;MOMBUCA;1791;1732;3523;0,508373545;0,491626455
412265;ROSARIO DO IVAI;2336;2259;4595;0,508378672;0,491621328
430057;ALTO FELIZ;1547;1496;3043;0,508379888;0,491620112
431250;MOSTARDAS;6552;6336;12888;0,508379888;0,491620112
521990;SAO FRANCISCO DE GOIAS;3185;3080;6265;0,508379888;0,491620112
421650;SAO JOAQUIM;13890;13432;27322;0,508381524;0,491618476
520330;BELA VISTA DE GOIAS;15762;15242;31004;0,508386015;0,491613985
431308;NOVA PADUA;1303;1260;2563;0,508388607;0,491611393
355200;SILVEIRAS;3241;3134;6375;0,508392157;0,491607843
221039;SAO MIGUEL DO FIDALGO;1544;1493;3037;0,508396444;0,491603556
291465;ITABELA;15710;15191;30901;0,508397786;0,491602214
316670;SERRA DOS AIMORES;4436;4289;8725;0,508424069;0,491575931
351640;FRANCO DA ROCHA;80555;77883;158438;0,508432321;0,491567679
412290;SALTO DO ITARARE;2472;2390;4862;0,508432744;0,491567256
171884;SANDOLANDIA;1714;1657;3371;0,508454465;0,491545535
150290;CURUCA;20894;20199;41093;0,508456428;0,491543572
421430;RANCHO QUEIMADO;1473;1424;2897;0,508457025;0,491542975
354040;POPULINA;2103;2033;4136;0,508462282;0,491537718
410740;ENEAS MARQUES;3003;2903;5906;0,508465967;0,491534033
210197;BOA VISTA DO GURUPI;4319;4175;8494;0,508476572;0,491523428
412450;SANTO INACIO;2757;2665;5422;0,508483954;0,491516046
220527;JATOBA DO PIAUI;2484;2401;4885;0,508495394;0,491504606
330530;SAO SEBASTIAO DO ALTO;4788;4628;9416;0,508496177;0,491503823
240690;LUCRECIA;2061;1992;4053;0,508512213;0,491487787
510774;SANTA CRUZ DO XINGU;1373;1327;2700;0,508518519;0,491481481
313230;ITAIPE;6565;6345;12910;0,508520527;0,491479473
510030;ALTO ARAGUAIA;10025;9689;19714;0,508521863;0,491478137
410465;CARAMBEI;12319;11906;24225;0,508524252;0,491475748
521530;ORIZONA;8052;7782;15834;0,508525957;0,491474043
355420;TEJUPA;2264;2188;4452;0,50853549;0,49146451
350115;ALUMINIO;9613;9290;18903;0,508543617;0,491456383
250670;IMACULADA;6040;5837;11877;0,508545929;0,491454071
310270;CACHOEIRA DE PAJEU;4816;4654;9470;0,508553326;0,491446674
351950;IBIRAREMA;4031;3895;7926;0,508579359;0,491420641
280560;PORTO DA FOLHA;14641;14147;28788;0,508579964;0,491420036
420070;ALFREDO WAGNER;5155;4981;10136;0,508583268;0,491416732
312820;GUARACIABA;5242;5065;10307;0,508586398;0,491413602
313750;LAGOA FORMOSA;9240;8928;18168;0,508586526;0,491413474
150420;MARABA;146303;141361;287664;0,508589883;0,491410117
350715;BOM SUCESSO DE ITARARE;2041;1972;4013;0,50859706;0,49140294
350710;BOM JESUS DOS PERDOES;13482;13024;26506;0,508639553;0,491360447
211160;SAO RAIMUNDO DAS MANGABEIRAS;9710;9380;19090;0,508643269;0,491356731
410685;CRUZMALTINA;1471;1421;2892;0,508644537;0,491355463
522060;SILVANIA;10650;10288;20938;0,50864457;0,49135543
315725;SANTA BARBARA DO LESTE;4177;4035;8212;0,508645884;0,491354116
354840;SANTOPOLIS DO AGUAPEI;2470;2386;4856;0,508649094;0,491350906
314770;PASSA TEMPO;4085;3946;8031;0,508653966;0,491346034
171665;PEQUIZEIRO;2821;2725;5546;0,508654886;0,491345114
412300;SALTO DO LONTRA;7608;7349;14957;0,508658153;0,491341847
420220;BENEDITO NOVO;6051;5845;11896;0,508658373;0,491341627
354080;POTIRENDABA;8987;8681;17668;0,508659724;0,491340276
351940;IBIRA;6429;6210;12639;0,50866366;0,49133634
210535;ITAIPAVA DO GRAJAU;8219;7939;16158;0,508664439;0,491335561
355310;TAIACU;3228;3118;6346;0,508666877;0,491333123
130180;IPIXUNA;15857;15315;31172;0,508693699;0,491306301
280630;SANTA LUZIA DO ITANHY;7226;6979;14205;0,508694122;0,491305878
172208;WANDERLANDIA;5994;5789;11783;0,508698973;0,491301027
431545;RELVADO;1052;1016;2068;0,508704062;0,491295938
312740;GONCALVES;2218;2142;4360;0,508715596;0,491284404
420580;GARUVA;9572;9244;18816;0,508715986;0,491284014
220585;MADEIRO;4259;4113;8372;0,508719541;0,491280459
520970;HIDROLANDIA;11463;11070;22533;0,508720543;0,491279457
430786;FAGUNDES VARELA;1399;1351;2750;0,508727273;0,491272727
351535;EUCLIDES DA CUNHA PAULISTA;4721;4559;9280;0,508728448;0,491271552
421530;SALETE;3904;3770;7674;0,508730779;0,491269221
510880;NOVA GUARITA;2242;2165;4407;0,508736102;0,491263898
110037;ALTO ALEGRE DOS PARECIS;6750;6518;13268;0,50874284;0,49125716
310330;ARACITABA;1046;1010;2056;0,508754864;0,491245136
210975;SANTA FILOMENA DO MARANHAO;4008;3870;7878;0,508758568;0,491241432
354670;SANTA GERTRUDES;14169;13681;27850;0,508761221;0,491238779
230880;MORAUJO;4494;4339;8833;0,508773916;0,491226084
520630;CRISTIANOPOLIS;1507;1455;2962;0,508777853;0,491222147
240410;GALINHOS;1477;1426;2903;0,508784017;0,491215983
312675;FRANCISCOPOLIS;2690;2597;5287;0,508795158;0,491204842
411373;LUIZIANA;3672;3545;7217;0,50879867;0,49120133
220360;ELISEU MARTINS;2515;2428;4943;0,508800324;0,491199676
150553;PARAUAPEBAS;111319;107468;218787;0,508800797;0,491199203
313850;LIBERDADE;2541;2453;4994;0,508810573;0,491189427
431300;NOVA BRESCIA;1702;1643;3345;0,508819133;0,491180867
241030;SERRA CAIADA;5417;5229;10646;0,508829607;0,491170393
221065;SIGEFREDO PACHECO;5126;4948;10074;0,508834624;0,491165376
420780;IRANI;5381;5194;10575;0,508841608;0,491158392
230780;MARCO;14157;13665;27822;0,508841924;0,491158076
210355;CONCEICAO DO LAGO-ACU;8426;8133;16559;0,508847153;0,491152847
411470;MARIA HELENA;2846;2747;5593;0,508850349;0,491149651
110040;ALTO PARAISO;11326;10932;22258;0,50885075;0,49114925
310200;ALTEROSA;7412;7154;14566;0,508856241;0,491143759
314505;NOVA PORTEIRINHA;3813;3680;7493;0,50887495;0,49112505
314570;OLIVEIRA FORTES;1083;1045;2128;0,508928571;0,491071429
354810;SANTO ANTONIO DO JARDIM;3016;2910;5926;0,508943638;0,491056362
310090;AGUAS FORMOSAS;9815;9470;19285;0,508944776;0,491055224
410712;DIAMANTE DO SUL;1735;1674;3409;0,508946905;0,491053095
313220;ITAGUARA;6876;6634;13510;0,508956329;0,491043671
291100;FLORESTA AZUL;5357;5168;10525;0,508978622;0,491021378
172080;SITIO NOVO DO TOCANTINS;4563;4402;8965;0,508979364;0,491020636
421330;PONTE ALTA;2351;2268;4619;0,508984629;0,491015371
412020;PORTO RICO;1300;1254;2554;0,509005482;0,490994518
316680;SERRA DO SALITRE;5981;5769;11750;0,509021277;0,490978723
240250;CARNAUBAIS;5585;5387;10972;0,509022968;0,490977032
520380;BRITANIA;2960;2855;5815;0,509028375;0,490971625
500795;TACURU;6004;5791;11795;0,50902925;0,49097075
315950;SANTA RITA DO ITUETO;2762;2664;5426;0,509030593;0,490969407
240430;GOVERNADOR DIX-SEPT ROSADO;6676;6439;13115;0,509035456;0,490964544
355260;TABAPUA;6394;6167;12561;0,509035905;0,490964095
411430;MANDIRITUBA;14126;13624;27750;0,509045045;0,490954955
355180;SETE BARRAS;6481;6250;12731;0,509072343;0,490927657
353720;PEDRO DE TOLEDO;5858;5649;11507;0,509081429;0,490918571
421200;PALMA SOLA;3727;3594;7321;0,509083459;0,490916541
316695;SERRANOPOLIS DE MINAS;2462;2374;4836;0,509098428;0,490901572
420710;ILHOTA;7398;7133;14531;0,509118436;0,490881564
353300;NOVA GRANADA;11135;10736;21871;0,509121668;0,490878332
314915;PEDRAS DE MARIA DA CRUZ;6269;6044;12313;0,509136685;0,490863315
310440;ARGIRITA;1365;1316;2681;0,509138381;0,490861619
280070;BREJO GRANDE;4275;4121;8396;0,509171034;0,490828966
313665;JUATUBA;14167;13656;27823;0,50918305;0,49081695
351240;CORDEIROPOLIS;12789;12327;25116;0,509197324;0,490802676
352400;ITUPEVA;32757;31573;64330;0,509202549;0,490797451
500350;DOURADINA;3068;2957;6025;0,509211618;0,490788382
314350;MORADA NOVA DE MINAS;4560;4395;8955;0,50921273;0,49078727
150820;VIGIA;27829;26821;54650;0,509222324;0,490777676
420190;AURORA;2896;2791;5687;0,509231581;0,490768419
280750;TOMAR DO GERU;6892;6642;13534;0,509235998;0,490764002
421175;OTACILIO COSTA;9778;9423;19201;0,50924431;0,49075569
241270;SAO PEDRO;2999;2890;5889;0,509254542;0,490745458
521830;POSSE;19313;18611;37924;0,509255353;0,490744647
292105;MATINA;6294;6065;12359;0,509264504;0,490735496
420985;LINDOIA DO SUL;2307;2223;4530;0,509271523;0,490728477
320070;ATILIO VIVACQUA;6249;6021;12270;0,509290954;0,490709046
230670;JAGUARETAMA;9235;8898;18133;0,50929245;0,49070755
316540;SAPUCAI-MIRIM;3588;3457;7045;0,509297374;0,490702626
430222;BOA VISTA DO CADEADO;1256;1210;2466;0,509326845;0,490673155
521260;MAIRIPOTABA;1201;1157;2358;0,509329941;0,490670059
291733;IUIU;5622;5416;11038;0,509331401;0,490668599
311750;CONCEICAO DO MATO DENTRO;8882;8556;17438;0,509347402;0,490652598
521490;NOVA ROMA;1634;1574;3208;0,509351621;0,490648379
110003;CABIXI;2581;2486;5067;0,509374383;0,490625617
171245;LUZINOPOLIS;1630;1570;3200;0,509375;0,490625
311360;CAREACU;3477;3349;6826;0,509375916;0,490624084
520013;ACREUNA;11568;11142;22710;0,509379128;0,490620872
350315;ARAPEI;1249;1203;2452;0,509380098;0,490619902
292210;MUNDO NOVO;13832;13321;27153;0,509409642;0,490590358
291780;JAGUARIPE;9762;9400;19162;0,509445778;0,490554222
431110;JAGUARI;5443;5241;10684;0,509453388;0,490546612
412033;PRADO FERREIRA;1939;1867;3806;0,509458749;0,490541251
315910;SANTANA DOS MONTES;1912;1841;3753;0,509459099;0,490540901
150580;PORTEL;32520;31311;63831;0,50947032;0,49052968
110175;VALE DO ANARI;5882;5663;11545;0,509484625;0,490515375
292940;SAO MIGUEL DAS MATAS;5978;5755;11733;0,509503111;0,490496889
231000;PALHANO;4819;4639;9458;0,509515754;0,490484246
521878;RIO QUENTE;2409;2319;4728;0,509517766;0,490482234
311030;CALDAS;7439;7161;14600;0,509520548;0,490479452
210930;PRESIDENTE VARGAS;5772;5556;11328;0,509533898;0,490466102
150440;MARAPANIM;14554;14009;28563;0,509540314;0,490459686
510550;VILA BELA DA SANTISSIMA TRINDADE;8363;8049;16412;0,509566171;0,490433829
293310;VARZEA DO POCO;4712;4535;9247;0,509570672;0,490429328
290160;ANTAS;10018;9641;19659;0,509588484;0,490411516
260060;ALAGOINHA;7541;7257;14798;0,509595891;0,490404109
522170;URUANA;7030;6765;13795;0,509604929;0,490395071
231350;TRAIRI;28871;27782;56653;0,509611142;0,490388858
352730;LOUVEIRA;25994;25013;51007;0,509616327;0,490383673
521910;SANTA BARBARA DE GOIAS;3415;3286;6701;0,509625429;0,490374571
313460;JABOTICATUBAS;10541;10142;20683;0,509645603;0,490354397
220556;LAGOA DO BARRO DO PIAUI;2374;2284;4658;0,509660799;0,490339201
352585;JUMIRIM;1767;1700;3467;0,509662532;0,490337468
292160;MORPARA;4320;4156;8476;0,509674375;0,490325625
292260;NILO PECANHA;7215;6941;14156;0,509677875;0,490322125
412760;TIJUCAS DO SUL;8815;8480;17295;0,50968488;0,49031512
261290;SAO BENEDITO DO SUL;8277;7962;16239;0,509698873;0,490301127
280240;GARARU;5912;5687;11599;0,509699112;0,490300888
353560;PARAIBUNA;9329;8973;18302;0,509725713;0,490274287
521090;ITAPACI;12157;11693;23850;0,509727463;0,490272537
312680;FREI GASPAR;2986;2872;5858;0,509730283;0,490269717
430471;CARAA;4295;4131;8426;0,509731783;0,490268217
412630;SENGES;9910;9531;19441;0,509747441;0,490252559
251320;SANTA CRUZ;3354;3225;6579;0,509803922;0,490196078
171840;PRESIDENTE KENNEDY;1870;1798;3668;0,509814613;0,490185387
170270;AURORA DO TOCANTINS;1942;1867;3809;0,509845104;0,490154896
314435;NAQUE;3622;3482;7104;0,509853604;0,490146396
420915;JOSE BOITEUX;2559;2460;5019;0,509862522;0,490137478
355110;SARAPUI;5350;5143;10493;0,509863719;0,490136281
310220;ALVARENGA;1929;1854;3783;0,509912768;0,490087232
420287;BRUNOPOLIS;1182;1136;2318;0,509922347;0,490077653
420060;AGUAS MORNAS;3389;3257;6646;0,509930785;0,490069215
421700;SAO LUDGERO;7081;6805;13886;0,509938067;0,490061933
431850;SAO JOSE DO NORTE;14210;13656;27866;0,509940429;0,490059571
352560;JOAO RAMALHO;2334;2243;4577;0,509941009;0,490058991
260700;INAJA;12256;11778;24034;0,509944246;0,490055754
315850;SANTANA DE PIRAPAMA;3844;3694;7538;0,509949589;0,490050411
510757;RONDOLANDIA;2075;1994;4069;0,509953305;0,490046695
412402;SANTA TEREZA DO OESTE;5128;4927;10055;0,509995027;0,490004973
412060;PRUDENTOPOLIS;26916;25860;52776;0,510004548;0,489995452
420270;BOTUVERA;2752;2644;5396;0,510007413;0,489992587
421220;PAPANDUVA;9956;9565;19521;0,510014856;0,489985144
290770;CHORROCHO;5723;5498;11221;0,510025844;0,489974156
421890;URUBICI;5769;5542;11311;0,51003448;0,48996552
314690;PAPAGAIOS;8121;7801;15922;0,510048989;0,489951011
320360;MUCURICI;2789;2679;5468;0,510058522;0,489941478
421450;RIO DO CAMPO;2991;2873;5864;0,510061392;0,489938608
150795;TAILANDIA;56900;54654;111554;0,510066873;0,489933127
210090;ARAIOSES;24022;23073;47095;0,51007538;0,48992462
171215;LAVANDEIRA;1012;972;1984;0,510080645;0,489919355
520995;INDIARA;8142;7820;15962;0,510086455;0,489913545
510860;VILA RICA;13745;13201;26946;0,510094263;0,489905737
314220;MIRAI;7756;7449;15205;0,510095363;0,489904637
210955;RIBAMAR FIQUENE;4009;3850;7859;0,510115791;0,489884209
432060;SEVERIANO DE ALMEIDA;1840;1767;3607;0,510119213;0,489880787
430550;CIRIACO;2394;2299;4693;0,510121457;0,489878543
230655;ITAREMA;21729;20866;42595;0,510130297;0,489869703
350275;ARACARIGUAMA;11908;11435;23343;0,510131517;0,489868483
353700;PEDREGULHO;8609;8267;16876;0,510132733;0,489867267
292480;PIRITIBA;12836;12326;25162;0,51013433;0,48986567
290130;ANDARAI;6694;6428;13122;0,51013565;0,48986435
350740;BORBOREMA;8304;7974;16278;0,51013638;0,48986362
240750;MAXARANGUAPE;6486;6228;12714;0,510146295;0,489853705
432253;VALE DO SOL;6057;5816;11873;0,510149078;0,489850922
290682;CANUDOS;8587;8245;16832;0,510159221;0,489840779
431937;SAO PEDRO DO BUTIA;1505;1445;2950;0,510169492;0,489830508
312920;HELIODORA;3379;3244;6623;0,510191756;0,489808244
270380;JOAQUIM GOMES;12330;11837;24167;0,510199859;0,489800141
130360;SANTA ISABEL DO RIO NEGRO;13554;13012;26566;0,510201009;0,489798991
412360;SANTA INES;800;768;1568;0,510204082;0,489795918
220885;RIACHO FRIO;2197;2109;4306;0,5102183;0,4897817
290450;BROTAS DE MACAUBAS;5462;5243;10705;0,510228865;0,489771135
520500;CARMO DO RIO VERDE;5255;5044;10299;0,510243713;0,489756287
432234;UBIRETAMA;996;956;1952;0,510245902;0,489754098
220975;SAO GONCALO DO GURGUEIA;1567;1504;3071;0,510257245;0,489742755
510792;SORRISO;48445;46496;94941;0,510264269;0,489735731
410290;BITURUNA;8374;8037;16411;0,510267504;0,489732496
291650;ITAPICURU;18458;17715;36173;0,510270091;0,489729909
240485;ITAJA;3899;3742;7641;0,510273524;0,489726476
355340;TANABI;13385;12846;26231;0,510274103;0,489725897
310780;BOM JESUS DO GALHO;7548;7244;14792;0,510275825;0,489724175
410275;BELA VISTA DA CAROBA;1737;1667;3404;0,510282021;0,489717979
411040;INDIANOPOLIS;2282;2190;4472;0,510286225;0,489713775
291125;GAVIAO;2254;2163;4417;0,510301109;0,489698891
410335;BRAGANEY;2724;2614;5338;0,510303484;0,489696516
353950;PITANGUEIRAS;20632;19798;40430;0,510314123;0,489685877
355535;UBARANA;3311;3177;6488;0,510326757;0,489673243
120010;BRASILEIA;13842;13281;27123;0,510341776;0,489658224
430250;BOSSOROCA;3131;3004;6135;0,510350448;0,489649552
522000;SAO JOAO D'ALIANCA;7361;7062;14423;0,510365389;0,489634611
411155;IVATE;4233;4061;8294;0,510368941;0,489631059
312860;GUARDA-MOR;3347;3211;6558;0,510369015;0,489630985
293020;SENTO SE;21068;20211;41279;0,510380581;0,489619419
220793;PEDRO LAURENTINO;1302;1249;2551;0,510388083;0,489611917
292570;PRESIDENTE JANIO QUADROS;6139;5889;12028;0,510392418;0,489607582
352460;JACUPIRANGA;9142;8769;17911;0,510412596;0,489587404
412460;SAO CARLOS DO IVAI;3553;3408;6961;0,51041517;0,48958483
315015;PIEDADE DE CARATINGA;4508;4324;8832;0,510416667;0,489583333
315880;SANTANA DO JACARE;2474;2373;4847;0,510418816;0,489581184
520010;ABADIANIA;10654;10219;20873;0,51042016;0,48957984
500515;JUTI;3502;3359;6861;0,510421221;0,489578779
355000;SAO LUIS DO PARAITINGA;5458;5235;10693;0,510427382;0,489572618
431085;JABOTICABA;1908;1830;3738;0,510433387;0,489566613
351120;CATIGUA;4035;3870;7905;0,510436433;0,489563567
290760;CENTRAL;8827;8466;17293;0,510437749;0,489562251
292340;PALMAS DE MONTE ALTO;11148;10692;21840;0,51043956;0,48956044
150690;SANTAREM NOVO;3469;3327;6796;0,510447322;0,489552678
315920;SANTA RITA DE CALDAS;4543;4357;8900;0,510449438;0,489550562
430830;FONTOURA XAVIER;5197;4984;10181;0,510460662;0,489539338
353370;OCAUCU;2192;2102;4294;0,510479739;0,489520261
430613;CRUZALTENSE;901;864;1765;0,510481586;0,489518414
315620;ROCHEDO DE MINAS;1192;1143;2335;0,510492505;0,489507495
210310;CEDRAL;5468;5243;10711;0,510503221;0,489496779
170110;APARECIDA DO RIO NEGRO;2502;2399;4901;0,51050806;0,48949194
350810;BURITAMA;8890;8524;17414;0,510508786;0,489491214
520520;CATURAI;2620;2512;5132;0,510522214;0,489477786
313970;MARAVILHAS;4142;3971;8113;0,510538642;0,489461358
312070;CRUZEIRO DA FORTALEZA;1864;1787;3651;0,510545056;0,489454944
316000;SANTO ANTONIO DO AVENTUREIRO;1839;1763;3602;0,510549695;0,489450305
430630;DAVID CANABARRO;2416;2316;4732;0,510566357;0,489433643
315440;RESSAQUINHA;2464;2362;4826;0,510567758;0,489432242
290200;ARACATU;6617;6343;12960;0,510570988;0,489429012
411925;PINHAL DE SAO BENTO;1400;1342;2742;0,510576222;0,489423778
110155;TEIXEIROPOLIS;2124;2036;4160;0,510576923;0,489423077
110146;PIMENTEIRAS DO OESTE;1086;1041;2127;0,510578279;0,489421721
210927;PRESIDENTE SARNEY;9812;9405;19217;0,510589582;0,489410418
314730;PARAISOPOLIS;10903;10450;21353;0,510607409;0,489392591
353020;MIRANTE DO PARANAPANEMA;9403;9012;18415;0,510616345;0,489383655
421060;MASSARANDUBA;8849;8481;17330;0,510617426;0,489382574
310170;ALMENARA;21640;20740;42380;0,510618216;0,489381784
431845;SAO JOSE DAS MISSOES;1272;1219;2491;0,510638298;0,489361702
316045;SANTO ANTONIO DO RETIRO;3736;3580;7316;0,510661564;0,489338436
421205;PALMEIRA;1365;1308;2673;0,510662177;0,489337823
320260;ICONHA;7192;6891;14083;0,510686643;0,489313357
290270;BARRA;27692;26533;54225;0,510686953;0,489313047
110033;NOVA MAMORE;16436;15748;32184;0,510688541;0,489311459
315230;PORTO FIRME;5829;5585;11414;0,510688628;0,489311372
510450;INDIAVAI;1433;1373;2806;0,510691376;0,489308624
431400;PARAI;3980;3813;7793;0,510714744;0,489285256
351220;CONCHAL;14551;13940;28491;0,510722684;0,489277316
521839;PROFESSOR JAMIL;1640;1571;3211;0,510744316;0,489255684
320255;IBITIRAMA;4510;4320;8830;0,510758777;0,489241223
261480;TACARATU;13504;12935;26439;0,510760619;0,489239381
210455;GOVERNADOR EDISON LOBAO;9572;9168;18740;0,510779082;0,489220918
310050;ACUCENA;4735;4535;9270;0,510787487;0,489212513
313390;ITAVERAVA;2718;2603;5321;0,510806239;0,489193761
251280;RIACHO DOS CAVALOS;4370;4185;8555;0,51081239;0,48918761
316050;SANTO ANTONIO DO RIO ABAIXO;897;859;1756;0,510820046;0,489179954
412690;TAPIRA;2785;2667;5452;0,510821717;0,489178283
320170;CONCEICAO DO CASTELO;6583;6304;12887;0,510824862;0,489175138
354900;SAO FRANCISCO;1437;1376;2813;0,510842517;0,489157483
160027;LARANJAL DO JARI;26719;25583;52302;0,510860005;0,489139995
420080;ANCHIETA;2798;2679;5477;0,510863611;0,489136389
312695;FREI LAGONEGRO;1786;1710;3496;0,510869565;0,489130435
430367;CAMPESTRE DA SERRA;1738;1664;3402;0,510875955;0,489124045
410773;FERNANDES PINHEIRO;2841;2720;5561;0,510879338;0,489120662
110001;ALTA FLORESTA D'OESTE;11503;11013;22516;0,510881151;0,489118849
220005;ACAUA;3637;3482;7119;0,51088636;0,48911364
312890;GUIMARANIA;4173;3995;8168;0,51089618;0,48910382
351440;DRACENA;24159;23128;47287;0,510901516;0,489098484
520860;GOIANESIA;36808;35237;72045;0,510902908;0,489097092
171420;NATIVIDADE;4729;4527;9256;0,510911841;0,489088159
310163;ALFREDO VASCONCELOS;3603;3449;7052;0,510918888;0,489081112
292640;RIACHO DE SANTANA;18269;17488;35757;0,510920939;0,489079061
431403;PARECI NOVO;1985;1900;3885;0,510939511;0,489060489
320100;BOA ESPERANCA;7739;7407;15146;0,510959989;0,489040011
314465;NINHEIRA;5291;5064;10355;0,510960888;0,489039112
411695;NOVA ESPERANCA DO SUDOESTE;2562;2452;5014;0,510969286;0,489030714
315890;SANTANA DO MANHUACU;4425;4235;8660;0,510969977;0,489030023
292040;MANOEL VITORINO;6614;6330;12944;0,510970334;0,489029666
354500;SALESOPOLIS;8872;8491;17363;0,510971606;0,489028394
150610;PRIMAVERA;5564;5325;10889;0,510974378;0,489025622
520660;CUMARI;1441;1379;2820;0,510992908;0,489007092
354800;SANTO ANTONIO DE POSSE;12132;11610;23742;0,510993177;0,489006823
293015;SERRA DO RAMALHO;16026;15336;31362;0,511000574;0,488999426
350945;CAMPINA DO MONTE ALEGRE;3111;2977;6088;0,511005256;0,488994744
430695;ENTRE RIOS DO SUL;1392;1332;2724;0,511013216;0,488986784
260392;CARNAUBEIRA DA PENHA;6703;6414;13117;0,511016238;0,488983762
170310;BARROLANDIA;2897;2772;5669;0,511024872;0,488975128
315500;RIO DOCE;1344;1286;2630;0,511026616;0,488973384
320501;SOORETAMA;15984;15294;31278;0,511030117;0,488969883
510820;TORIXOREU;1782;1705;3487;0,511041009;0,488958991
431820;SAO FRANCISCO DE PAULA;11177;10694;21871;0,511042019;0,488957981
420765;IPORA DO OESTE;4647;4446;9093;0,511052458;0,488947542
313580;JEQUITINHONHA;13060;12495;25555;0,511054588;0,488945412
521487;NOVA IGUACU DE GOIAS;1502;1437;2939;0,511058183;0,488941817
411500;MARILENA;3625;3468;7093;0,511067249;0,488932751
260630;GRANITO;3877;3709;7586;0,511073029;0,488926971
220285;CORONEL JOSE DIAS;2396;2292;4688;0,51109215;0,48890785
431142;LAJEADO DO BUGRE;1313;1256;2569;0,511093811;0,488906189
351580;FLORA RICA;714;683;1397;0,511095204;0,488904796
313160;IRAI DE MINAS;3612;3455;7067;0,511107967;0,488892033
291350;IGUAI;13803;13203;27006;0,511108643;0,488891357
355020;SAO MIGUEL ARCANJO;16903;16168;33071;0,511112455;0,488887545
311760;CONCEICAO DO PARA;2841;2717;5558;0,511155092;0,488844908
421415;PRINCESA;1508;1442;2950;0,511186441;0,488813559
110092;CHUPINGUAIA;6009;5746;11755;0,511186729;0,488813271
313925;MAMONAS;3356;3209;6565;0,511195735;0,488804265
431846;SAO JOSE DO HERVAL;980;937;1917;0,511215441;0,488784559
314537;NOVORIZONTE;2734;2614;5348;0,511219147;0,488780853
351400;DOBRADA;4646;4442;9088;0,511223592;0,488776408
410785;FLOR DA SERRA DO SUL;2343;2240;4583;0,511237181;0,488762819
420757;IOMERE;1523;1456;2979;0,511245384;0,488754616
412175;RESERVA DO IGUACU;4155;3972;8127;0,511258767;0,488741233
421630;SAO JOAO BATISTA;20307;19412;39719;0,511266648;0,488733352
220553;JUREMA;2449;2341;4790;0,511273486;0,488726514
351720;GUAICARA;6348;6068;12416;0,511275773;0,488724227
293210;UBAIRA;10154;9706;19860;0,511278953;0,488721047
130010;ANORI;11216;10721;21937;0,511282308;0,488717692
510618;NOVA LACERDA;3508;3353;6861;0,511295729;0,488704271
241280;SAO RAFAEL;4184;3999;8183;0,511303923;0,488696077
291490;ITACARE;14854;14197;29051;0,5113077;0,4886923
150715;SAO DOMINGOS DO ARAGUAIA;13266;12679;25945;0,511312392;0,488687608
210480;GRAJAU;36146;34546;70692;0,511316698;0,488683302
421240;PEDRAS GRANDES;2010;1921;3931;0,511320275;0,488679725
211163;SAO RAIMUNDO DO DOCA BEZERRA;2571;2457;5028;0,511336516;0,488663484
211200;TASSO FRAGOSO;4419;4223;8642;0,511339968;0,488660032
431842;SAO JOAO DA URTIGA;2365;2260;4625;0,511351351;0,488648649
412395;SANTA MONICA;2072;1980;4052;0,511352419;0,488647581
316610;SENHORA DO PORTO;1798;1718;3516;0,511376564;0,488623436
310190;ALPINOPOLIS;10258;9801;20059;0,511391395;0,488608605
312352;DURANDE;4039;3859;7898;0,51139529;0,48860471
320400;PANCAS;11980;11446;23426;0,511397592;0,488602408
311350;CARBONITA;4819;4604;9423;0,511408256;0,488591744
312050;CRISTINA;5222;4989;10211;0,511409265;0,488590735
220208;CAJUEIRO DA PRAIA;3940;3764;7704;0,511422638;0,488577362
411490;MARILANDIA DO SUL;4497;4296;8793;0,511429546;0,488570454
521470;NOVA AMERICA;1208;1154;2362;0,511430991;0,488569009
420517;ENTRE RIOS;1653;1579;3232;0,51144802;0,48855198
313370;ITATIAIUCU;5807;5547;11354;0,511449709;0,488550291
150570;PONTA DE PEDRAS;16370;15637;32007;0,51145062;0,48854938
311880;CORACAO DE JESUS;13615;13005;26620;0,511457551;0,488542449
120080;PORTO ACRE;9790;9351;19141;0,51146753;0,48853247
311700;COMERCINHO;3388;3236;6624;0,51147343;0,48852657
311300;CARAI;12210;11662;23872;0,511477882;0,488522118
241460;UPANEMA;7640;7297;14937;0,511481556;0,488518444
211172;SATUBINHA;7301;6973;14274;0,511489421;0,488510579
231375;UMIRIM;10218;9758;19976;0,511513817;0,488486183
311990;CORREGO DO BOM JESUS;1885;1800;3685;0,511533243;0,488466757
315690;SACRAMENTO;13585;12971;26556;0,511560476;0,488439524
210015;AGUA DOCE DO MARANHAO;6513;6218;12731;0,511585893;0,488414107
220552;JULIO BORGES;2892;2761;5653;0,511586768;0,488413232
316040;SANTO ANTONIO DO MONTE;14633;13970;28603;0,511589693;0,488410307
420510;DONA EMMA;2161;2063;4224;0,511600379;0,488399621
241370;SITIO NOVO;2865;2735;5600;0,511607143;0,488392857
291680;ITARANTIM;10200;9737;19937;0,511611576;0,488388424
421030;MAJOR VIEIRA;4200;4009;8209;0,511633573;0,488366427
421145;NOVA ITABERABA;2214;2113;4327;0,511670904;0,488329096
430485;CARLOS GOMES;679;648;1327;0,511680482;0,488319518
411660;NOVA AMERICA DA COLINA;1752;1672;3424;0,511682243;0,488317757
410410;CAMPO DO TENENTE;4154;3964;8118;0,51170239;0,48829761
150555;PAU D'ARCO;2732;2607;5339;0,511706312;0,488293688
354710;SANTA MERCEDES;1508;1439;2947;0,51170682;0,48829318
312738;GOIANA;2054;1960;4014;0,511709018;0,488290982
292450;PINDAI;8345;7963;16308;0,511712043;0,488287957
350340;AREALVA;4434;4231;8665;0,511713791;0,488286209
290689;CARAIBAS;4431;4228;8659;0,511721908;0,488278092
520145;APARECIDA DO RIO DOCE;1266;1208;2474;0,511721908;0,488278092
520551;COCALZINHO DE GOIAS;10629;10142;20771;0,511723075;0,488276925
510517;JURUENA;8603;8208;16811;0,51174826;0,48825174
520055;ALTO HORIZONTE;3478;3318;6796;0,51177163;0,48822837
410440;CANDIDO DE ABREU;7475;7131;14606;0,511775982;0,488224018
351565;FERNAO;890;849;1739;0,511788384;0,488211616
110160;THEOBROMA;5296;5052;10348;0,511789718;0,488210282
210596;LAGOA GRANDE DO MARANHAO;5903;5631;11534;0,511791226;0,488208774
521350;MONTE ALEGRE DE GOIAS;4483;4276;8759;0,511816417;0,488183583
220191;BOM PRINCIPIO DO PIAUI;2902;2768;5670;0,511816578;0,488183422
352965;MESOPOLIS;974;929;1903;0,511823437;0,488176563
354300;RIBEIRAO BRANCO;8181;7803;15984;0,511824324;0,488175676
220755;PAQUETA;2012;1919;3931;0,511829051;0,488170949
421740;SCHROEDER;11570;11035;22605;0,511833665;0,488166335
292285;NOVA REDENCAO;4671;4455;9126;0,51183432;0,48816568
510510;JUARA;18055;17220;35275;0,511835578;0,488164422
421885;UNIAO DO OESTE;1210;1154;2364;0,511844332;0,488155668
351920;IACRI;3209;3060;6269;0,511883873;0,488116127
210050;ALTO PARNAIBA;5750;5483;11233;0,511884626;0,488115374
350620;BENTO DE ABREU;1550;1478;3028;0,511889036;0,488110964
231040;PARAMOTI;6284;5992;12276;0,511893125;0,488106875
313055;IMBE DE MINAS;3571;3405;6976;0,511897936;0,488102064
240895;RIO DO FOGO;5611;5350;10961;0,511905848;0,488094152
170555;COMBINADO;2493;2377;4870;0,511909651;0,488090349
261140;PRIMAVERA;7797;7434;15231;0,511916486;0,488083514
120001;ACRELANDIA;8048;7673;15721;0,511926722;0,488073278
353570;PARAISO;3346;3190;6536;0,511933905;0,488066095
412667;TAMARANA;7821;7456;15277;0,511946063;0,488053937
315350;ALTO JEQUITIBA;4242;4044;8286;0,511947864;0,488052136
250530;CURRAL VELHO;1284;1224;2508;0,511961722;0,488038278
311110;CAMPINA VERDE;10116;9643;19759;0,511969229;0,488030771
430050;ALPESTRE;3013;2872;5885;0,511979609;0,488020391
310610;BELMIRO BRAGA;1752;1670;3422;0,511981297;0,488018703
352810;MACAUBAL;4185;3989;8174;0,511989234;0,488010766
352620;JUQUITIBA;16304;15540;31844;0,51199598;0,48800402
312733;GAMELEIRAS;2603;2481;5084;0,511998426;0,488001574
110050;NOVO HORIZONTE DO OESTE;4160;3965;8125;0,512;0,488
352850;MAIRIPORA;53067;50578;103645;0,512007333;0,487992667
420130;ARAQUARI;20936;19954;40890;0,512007826;0,487992174
421710;SAO MARTINHO;1619;1543;3162;0,51201771;0,48798229
317103;VERDELANDIA;4878;4649;9527;0,512018474;0,487981526
315935;SANTA RITA DE MINAS;3749;3573;7322;0,512018574;0,487981426
421895;URUPEMA;1256;1197;2453;0,512026091;0,487973909
312707;FRUTA DE LEITE;2679;2553;5232;0,512041284;0,487958716
521970;SANTA TEREZINHA DE GOIAS;4294;4092;8386;0,512043883;0,487956117
290330;BARRO PRETO;2720;2592;5312;0,512048193;0,487951807
220157;BELEM DO PIAUI;1847;1760;3607;0,512059884;0,487940116
431454;PINTO BANDEIRA;1571;1497;3068;0,512059974;0,487940026
311090;CAMPANHA;8631;8224;16855;0,512073569;0,487926431
510305;CLAUDIA;6318;6020;12338;0,512076512;0,487923488
314380;MUNHOZ;3052;2908;5960;0,512080537;0,487919463
150210;CAMETA;72110;68704;140814;0,512093968;0,487906032
420310;CAIBI;3130;2982;6112;0,51210733;0,48789267
241255;SAO MIGUEL DO GOSTOSO;5347;5094;10441;0,512115698;0,487884302
430180;BARRACAO;2682;2555;5237;0,512125263;0,487874737
520552;COLINAS DO SUL;1710;1629;3339;0,51212938;0,48787062
510670;PONTE BRANCA;781;744;1525;0,512131148;0,487868852
291270;IBIRAPITANGA;12001;11432;23433;0,512140998;0,487859002
170740;ESPERANTINA;5777;5503;11280;0,51214539;0,48785461
130353;PRESIDENTE FIGUEIREDO;19511;18584;38095;0,512166951;0,487833049
350120;ALVARES FLORENCE;1852;1764;3616;0,512168142;0,487831858
431043;IPE;3450;3286;6736;0,512173397;0,487826603
500260;CAMAPUA;7004;6671;13675;0,512175503;0,487824497
411650;NOVA ALIANCA DO IVAI;799;761;1560;0,512179487;0,487820513
316165;SAO GERALDO DO BAIXIO;2102;2002;4104;0,512183236;0,487816764
292330;OURICANGAS;4392;4183;8575;0,512186589;0,487813411
313630;JOAO PINHEIRO;24580;23410;47990;0,51219004;0,48780996
251300;SALGADINHO;2036;1939;3975;0,512201258;0,487798742
241180;SAO FERNANDO;1847;1759;3606;0,512201886;0,487798114
314360;MORRO DA GARCA;1236;1177;2413;0,512225446;0,487774554
220245;CAPITAO GERVASIO OLIVEIRA;2114;2013;4127;0,512236491;0,487763509
421835;TREVISO;2050;1952;4002;0,512243878;0,487756122
130420;TEFE;30351;28899;59250;0,512253165;0,487746835
520620;CRISTALINA;31445;29940;61385;0,512258695;0,487741305
353657;PAULISTANIA;940;895;1835;0,51226158;0,48773842
315645;ROSARIO DA LIMEIRA;2381;2267;4648;0,512263339;0,487736661
430912;GRAMADO DOS LOUREIROS;1043;993;2036;0,512278978;0,487721022
510530;LUCIARA;1043;993;2036;0,512278978;0,487721022
520080;ALVORADA DO NORTE;4482;4267;8749;0,512287119;0,487712881
311660;CLAUDIO;14904;14189;29093;0,512288179;0,487711821
420435;CORDILHEIRA ALTA;2349;2236;4585;0,512322792;0,487677208
520180;ARAGOIANIA;5472;5208;10680;0,512359551;0,487640449
312280;DOM VICOSO;1533;1459;2992;0,51236631;0,48763369
170040;ALMAS;3538;3367;6905;0,512382332;0,487617668
150040;ALENQUER;29406;27984;57390;0,512388918;0,487611082
430235;BOM PRINCIPIO;7402;7044;14446;0,512390973;0,487609027
500720;RIO BRILHANTE;19904;18940;38844;0,512408609;0,487591391
431065;ITATI;1218;1159;2377;0,512410602;0,487589398
210510;ICATU;14052;13371;27423;0,512416585;0,487583415
420243;BOCAINA DO SUL;1794;1707;3501;0,512425021;0,487574979
220740;PALMEIRA DO PIAUI;2577;2452;5029;0,512427918;0,487572082
311050;CAMANDUCAIA;11187;10644;21831;0,512436444;0,487563556
317000;UBAI;6488;6173;12661;0,512439776;0,487560224
291430;IRAMAIA;4035;3839;7874;0,512446025;0,487553975
350030;AGUAI;18951;18030;36981;0,51245234;0,48754766
150540;OUREM;9265;8814;18079;0,512473035;0,487526965
421505;RIO RUFINO;1273;1211;2484;0,512479871;0,487520129
430200;BARROS CASSAL;5723;5444;11167;0,512492164;0,487507836
431642;SAGRADA FAMILIA;1333;1268;2601;0,512495194;0,487504806
230837;MIRAIMA;7157;6808;13965;0,512495525;0,487504475
431087;JACUIZINHO;1393;1325;2718;0,512509198;0,487490802
412853;VENTANIA;6287;5980;12267;0,512513247;0,487486753
150160;BONITO;8595;8174;16769;0,512552925;0,487447075
430783;EUGENIO DE CASTRO;1184;1126;2310;0,512554113;0,487445887
354105;PRATANIA;2753;2618;5371;0,512567492;0,487432508
240440;GROSSOS;5403;5138;10541;0,512569965;0,487430035
314210;MIRADOURO;5545;5273;10818;0,51257164;0,48742836
130340;PARINTINS;59684;56755;116439;0,512577401;0,487422599
130185;IRANDUBA;25485;24233;49718;0,512591013;0,487408987
315510;RIO DO PRADO;2623;2494;5117;0,512605042;0,487394958
412170;RESERVA;13806;13127;26933;0,512605354;0,487394646
150350;IRITUIA;16731;15908;32639;0,512607617;0,487392383
350510;BARBOSA;3861;3671;7532;0,512612852;0,487387148
150309;GOIANESIA DO PARA;21365;20313;41678;0,512620567;0,487379433
410620;CONTENDA;9782;9300;19082;0,512629703;0,487370297
411020;INACIO MARTINS;5699;5418;11117;0,512638302;0,487361698
150500;NOVA TIMBOTEUA;8021;7625;15646;0,512654992;0,487345008
130100;CARAUARI;14723;13996;28719;0,512657126;0,487342874
312840;GUARANI;4576;4350;8926;0,512659646;0,487340354
210805;PAULINO NEVES;8354;7941;16295;0,512672599;0,487327401
320316;LARANJA DA TERRA;5598;5321;10919;0,512684312;0,487315688
220095;AROEIRAS DO ITAIM;1308;1243;2551;0,512740102;0,487259898
430063;AMARAL FERRADOR;3659;3477;7136;0,512752242;0,487247758
314370;MORRO DO PILAR;1603;1523;3126;0,512795905;0,487204095
240615;JUNDIA;2023;1922;3945;0,512801014;0,487198986
110140;MONTE NEGRO;8286;7872;16158;0,512810991;0,487189009
171660;PEIXE;6152;5844;11996;0,512837613;0,487162387
130370;SANTO ANTONIO DO ICA;10713;10176;20889;0,512853655;0,487146345
130150;ENVIRA;10641;10107;20748;0,51286871;0,48713129
280540;POCO REDONDO;18187;17274;35461;0,512873297;0,487126703
293245;UMBURANAS;10039;9534;19573;0,512900424;0,487099576
210260;CANDIDO MENDES;10451;9925;20376;0,512907342;0,487092658
320455;SANTA MARIA DE JETIBA;21331;20257;41588;0,512912379;0,487087621
510719;RIBEIRAOZINHO;1251;1188;2439;0,512915129;0,487084871
430360;CAMBARA DO SUL;3274;3109;6383;0,512924957;0,487075043
420030;AGRONOMICA;2857;2713;5570;0,512926391;0,487073609
520480;CAMPO ALEGRE DE GOIAS;4044;3840;7884;0,512937595;0,487062405
350370;ARIRANHA;5053;4798;9851;0,512942848;0,487057152
312450;ESTIVA;5856;5560;11416;0,512964261;0,487035739
510600;NORTELANDIA;3005;2853;5858;0,512973711;0,487026289
521483;NOVA CRIXAS;6679;6341;13020;0,512980031;0,487019969
430260;BRAGA;1678;1593;3271;0,512992969;0,487007031
291240;IBIPEBA;9450;8971;18421;0,513001466;0,486998534
351907;HORTOLANDIA;121874;115696;237570;0,513002483;0,486997517
314437;NATALANDIA;1696;1610;3306;0,513006655;0,486993345
354325;RIBEIRAO GRANDE;3943;3743;7686;0,513010669;0,486989331
420555;FREI ROGERIO;984;934;1918;0,513034411;0,486965589
210250;CAJARI;10015;9506;19521;0,513037242;0,486962758
317080;VARZEA DA PALMA;20574;19527;40101;0,513054537;0,486945463
412040;PRESIDENTE CASTELO BRANCO;2768;2627;5395;0,513067655;0,486932345
311780;CONCEICAO DOS OUROS;6081;5771;11852;0,513077962;0,486922038
316630;SERICITA;3766;3574;7340;0,513079019;0,486920981
240510;JANDAIRA;3544;3363;6907;0,513102649;0,486897351
290395;BOM JESUS DA SERRA;5012;4756;9768;0,513104013;0,486895987
520470;CAMPINORTE;6609;6271;12880;0,513121118;0,486878882
313140;IPIACU;2170;2059;4229;0,51312367;0,48687633
352950;MENDONCA;2893;2745;5638;0,513125222;0,486874778
316270;SAO JOAO DO PARAISO;12211;11586;23797;0,513131907;0,486868093
130220;JURUA;7951;7544;15495;0,513133269;0,486866731
290640;CANDEAL;4161;3948;8109;0,513133555;0,486866445
317052;URUCUIA;8965;8505;17470;0,513165426;0,486834574
290755;CATURAMA;4774;4529;9303;0,513167795;0,486832205
431449;PINHEIRINHO DO VALE;2528;2398;4926;0,51319529;0,48680471
431050;IRAI;3616;3430;7046;0,513198978;0,486801022
350770;BRAUNA;2974;2821;5795;0,513201035;0,486798965
521935;SANTA ISABEL;1961;1860;3821;0,513216435;0,486783565
220890;RIBEIRO GONCALVES;3802;3606;7408;0,513228942;0,486771058
311200;CANDEIAS;7642;7248;14890;0,513230356;0,486769644
291010;DOM BASILIO;6303;5978;12281;0,513231822;0,486768178
172110;TOCANTINIA;3946;3742;7688;0,51326743;0,48673257
310450;ARINOS;9162;8688;17850;0,513277311;0,486722689
352130;IPUA;8620;8174;16794;0,513278552;0,486721448
351420;DOLCINOPOLIS;1082;1026;2108;0,513282732;0,486717268
522108;TERESINA DE GOIAS;1816;1722;3538;0,513284341;0,486715659
431235;MONTAURI;734;696;1430;0,513286713;0,486713287
291130;GENTIO DO OURO;5792;5492;11284;0,513293158;0,486706842
520830;DIVINOPOLIS DE GOIAS;2413;2288;4701;0,513295044;0,486704956
130140;EIRUNEPE;18541;17580;36121;0,513302511;0,486697489
313655;JOSE RAYDAN;2620;2484;5104;0,513322884;0,486677116
510775;SALTO DO CEU;1656;1570;3226;0,5133292;0,4866708
313410;ITUETA;3118;2956;6074;0,513335528;0,486664472
150260;COLARES;6250;5925;12175;0,513347023;0,486652977
250485;COXIXOLA;1000;948;1948;0,513347023;0,486652977
291740;JACARACI;7626;7229;14855;0,513362504;0,486637496
313600;JOAIMA;7945;7531;15476;0,513375549;0,486624451
292780;SANTA CRUZ DA VITORIA;3204;3037;6241;0,513379266;0,486620734
510337;COTRIGUACU;10636;10081;20717;0,513394797;0,486605203
316030;SANTO ANTONIO DO JACINTO;5940;5630;11570;0,513396716;0,486603284
311630;CIPOTANEA;3497;3314;6811;0,513434151;0,486565849
520440;CAIAPONIA;9912;9392;19304;0,513468711;0,486531289
410600;CONGONHINHAS;4568;4328;8896;0,513489209;0,486510791
314810;PATROCINIO;47303;44813;92116;0,513515567;0,486484433
290990;CURACA;18008;17057;35065;0,51356053;0,48643947
241390;TAIPU;6324;5990;12314;0,5135618;0,4864382
522145;TROMBAS;1796;1701;3497;0,513583071;0,486416929
411740;OURIZONA;1758;1665;3423;0,513584575;0,486415425
354930;SAO JOAO DO PAU D'ALHO;1076;1019;2095;0,513603819;0,486396181
351290;COSMORAMA;3744;3545;7289;0,513650707;0,486349293
220300;CRISTALANDIA DO PIAUI;4289;4061;8350;0,513652695;0,486347305
351890;GUZOLANDIA;2746;2600;5346;0,513655069;0,486344931
431173;MAMPITUBA;1523;1442;2965;0,513659359;0,486340641
316230;SAO JOAO DA MATA;1409;1334;2743;0,513671163;0,486328837
312030;CRISTALIA;3078;2914;5992;0,513684913;0,486315087
320180;DIVINO DE SAO LOURENCO;2176;2060;4236;0,513692162;0,486307838
312780;GRAO MOGOL;8190;7753;15943;0,513705074;0,486294926
315320;PRESIDENTE JUSCELINO;1835;1737;3572;0,513717805;0,486282195
522230;VILA PROPICIO;3052;2889;5941;0,513718229;0,486281771
220327;CURRAL NOVO DO PIAUI;2769;2621;5390;0,513729128;0,486270872
313290;ITAMOGI;5200;4922;10122;0,513732464;0,486267536
150300;FARO;3570;3379;6949;0,513742985;0,486257015
313862;LIMEIRA DO OESTE;3925;3715;7640;0,513743455;0,486256545
230533;IBICUITINGA;6540;6190;12730;0,513747054;0,486252946
350500;BARAO DE ANTONINA;1811;1714;3525;0,513758865;0,486241135
261040;PARNAMIRIM;11405;10793;22198;0,513785026;0,486214974
210030;ALDEIAS ALTAS;13862;13117;26979;0,513807035;0,486192965
431555;RIO DOS INDIOS;1321;1250;2571;0,513807857;0,486192143
500560;MIRANDA;14604;13819;28423;0,513809239;0,486190761
351980;ICEM;4297;4066;8363;0,513810833;0,486189167
210610;LORETO;6305;5966;12271;0,513813055;0,486186945
420895;JARDINOPOLIS;781;739;1520;0,513815789;0,486184211
313000;IBITURUNA;1543;1460;3003;0,513819514;0,486180486
241500;VILA FLOR;1653;1564;3217;0,513832763;0,486167237
520130;ANICUNS;11363;10750;22113;0,513860625;0,486139375
410520;CERRO AZUL;9190;8694;17884;0,513867144;0,486132856
430637;DILERMANDO DE AGUIAR;1537;1454;2991;0,513874958;0,486125042
510627;NOVO HORIZONTE DO NORTE;2091;1978;4069;0,513885476;0,486114524
120042;RODRIGUES ALVES;10158;9609;19767;0,513886781;0,486113219
353190;MORRO AGUDO;17266;16332;33598;0,513899637;0,486100363
312140;DESTERRO DE ENTRE RIOS;3734;3532;7266;0,513900358;0,486099642
410725;DOURADINA;4619;4369;8988;0,513907432;0,486092568
411575;MAUA DA SERRA;5650;5344;10994;0,513916682;0,486083318
210670;MIRADOR;10816;10229;21045;0,513946306;0,486053694
313480;JACUI;3955;3740;7695;0,51397011;0,48602989
352265;ITAPIRAPUA PAULISTA;2207;2087;4294;0,513972986;0,486027014
316130;SAO FRANCISCO DE SALES;3243;3066;6309;0,51402758;0,48597242
260515;DORMENTES;9893;9353;19246;0,514028889;0,485971111
221063;SEBASTIAO LEAL;2216;2095;4311;0,514033867;0,485966133
430995;IBIRAPUITA;2050;1938;3988;0,514042126;0,485957874
210825;PEDRO DO ROSARIO;13139;12421;25560;0,514045383;0,485954617
292760;SANTA BRIGIDA;7154;6763;13917;0,514047568;0,485952432
421090;MODELO;2173;2054;4227;0,514076177;0,485923823
316140;SAO FRANCISCO DO GLORIA;2446;2312;4758;0,514081547;0,485918453
432023;SEDE NOVA;1478;1397;2875;0,514086957;0,485913043
130165;GUAJARA;8839;8354;17193;0,514104577;0,485895423
220551;JUAZEIRO DO PIAUI;2823;2668;5491;0,514114005;0,485885995
510335;CONFRESA;16491;15585;32076;0,514122709;0,485877291
330590;TRAJANO DE MORAES;5477;5176;10653;0,514127476;0,485872524
355080;SAO SEBASTIAO DA GRAMA;6240;5897;12137;0,514130345;0,485869655
292265;NORDESTINA;6785;6412;13197;0,514132;0,485868
500295;CHAPADAO DO SUL;13624;12875;26499;0,514132609;0,485867391
521810;PORTELANDIA;2073;1959;4032;0,514136905;0,485863095
353220;NARANDIBA;2545;2405;4950;0,514141414;0,485858586
291077;FEIRA DA MATA;2908;2748;5656;0,514144272;0,485855728
171515;NOVO ALEGRE;1199;1133;2332;0,514150943;0,485849057
130380;SAO GABRIEL DA CACHOEIRA;24182;22849;47031;0,514171504;0,485828496
430710;HERVAL;3500;3307;6807;0,514176583;0,485823417
110026;RIO CRESPO;1976;1867;3843;0,514181629;0,485818371
312060;CRUCILANDIA;2608;2464;5072;0,514195584;0,485804416
210315;CENTRO DO GUILHERME;7135;6741;13876;0,514197175;0,485802825
311455;CARNEIRINHO;5195;4908;10103;0,514203702;0,485796298
317115;VERMELHO NOVO;2495;2357;4852;0,51422094;0,48577906
430605;CRISTAL;4176;3945;8121;0,514222386;0,485777614
311190;CANA VERDE;2872;2713;5585;0,514234557;0,485765443
431160;LIBERATO SALZANO;2616;2471;5087;0,514252015;0,485747985
314260;MONSENHOR PAULO;4507;4257;8764;0,514262894;0,485737106
351260;CORONEL MACEDO;2361;2230;4591;0,514267044;0,485732956
240280;CORONEL EZEQUIEL;2829;2672;5501;0,514270133;0,485729867
312580;FERNANDES TOURINHO;1800;1700;3500;0,514285714;0,485714286
420055;AGUAS FRIAS;1204;1137;2341;0,514310124;0,485689876
210923;PRESIDENTE MEDICI;3664;3460;7124;0,514317799;0,485682201
315170;POCO FUNDO;8692;8208;16900;0,514319527;0,485680473
431200;MARIANO MORO;1022;965;1987;0,514343231;0,485656769
261520;TERRA NOVA;5305;5009;10314;0,514349428;0,485650572
421055;MAREMA;876;827;1703;0,514386377;0,485613623
241475;VENHA-VER;2177;2055;4232;0,514413989;0,485586011
210215;BREJO DE AREIA;4548;4293;8841;0,514421446;0,485578554
412120;QUITANDINHA;9974;9414;19388;0,514441923;0,485558077
290340;BELMONTE;12110;11430;23540;0,5144435;0,4855565
311170;CANAA;2332;2201;4533;0,514449592;0,485550408
520740;EDEIA;6461;6098;12559;0,514451788;0,485548212
420768;IPUACU;3932;3711;7643;0,514457674;0,485542326
421568;SANTA TEREZINHA DO PROGRESSO;1192;1125;2317;0,514458351;0,485541649
310205;ALTO CAPARAO;3055;2883;5938;0,514482991;0,485517009
231123;POTIRETAMA;3321;3134;6455;0,514484895;0,485515105
172090;TAGUATINGA;8729;8237;16966;0,514499587;0,485500413
315217;PONTO DOS VOLANTES;6295;5940;12235;0,51450756;0,48549244
315010;PIAU;1399;1320;2719;0,5145274;0,4854726
261210;SALGADINHO;5770;5444;11214;0,514535402;0,485464598
150050;ALMEIRIM;17517;16527;34044;0,514540007;0,485459993
316255;SAO JOAO DO MANHUACU;6064;5721;11785;0,514552397;0,485447603
431335;NOVA ROMA DO SUL;1926;1817;3743;0,514560513;0,485439487
350200;ANALANDIA;2632;2483;5115;0,514565005;0,485434995
260915;MANARI;11378;10732;22110;0,514608774;0,485391226
312340;DORESOPOLIS;792;747;1539;0,514619883;0,485380117
310680;BIAS FORTES;1689;1593;3282;0,514625229;0,485374771
520396;BURITINOPOLIS;1684;1588;3272;0,514669927;0,485330073
352350;ITATINGA;10880;10259;21139;0,51468849;0,48531151
351885;GUATAPARA;3994;3766;7760;0,514690722;0,485309278
421555;SANTA HELENA;1121;1057;2178;0,514692378;0,485307622
250435;CATURITE;2521;2377;4898;0,514699878;0,485300122
354630;SANTA CRUZ DAS PALMEIRAS;18067;17035;35102;0,514700017;0,485299983
316805;TAPARUBA;1592;1501;3093;0,514710637;0,485289363
350110;ALTO ALEGRE;2099;1979;4078;0,514713095;0,485286905
230075;AMONTADA;22748;21447;44195;0,51471886;0,48528114
211167;SAO ROBERTO;3529;3327;6856;0,514731622;0,485268378
170025;ABREULANDIA;1343;1266;2609;0,514756612;0,485243388
313280;ITAMBE DO MATO DENTRO;1046;986;2032;0,51476378;0,48523622
311560;CEDRO DO ABAETE;592;558;1150;0,514782609;0,485217391
510724;SANTA CARMEM;2368;2232;4600;0,514782609;0,485217391
353284;NOVA CANAA PAULISTA;939;885;1824;0,514802632;0,485197368
352090;IPAUSSU;7807;7358;15165;0,514803825;0,485196175
420050;AGUAS DE CHAPECO;3369;3175;6544;0,514822738;0,485177262
421110;MONTE CASTELO;4254;4009;8263;0,514825124;0,485174876
330227;JAPERI;54724;51572;106296;0,514826522;0,485173478
317140;VIEIRAS;1838;1732;3570;0,514845938;0,485154062
220202;BURITI DOS MONTES;4264;4018;8282;0,514851485;0,485148515
510120;ARAGUAINHA;468;441;909;0,514851485;0,485148515
411390;MALLET;7052;6645;13697;0,514857268;0,485142732
241410;TENENTE ANANIAS;5624;5299;10923;0,514876865;0,485123135
311490;CASA GRANDE;1159;1092;2251;0,514882275;0,485117725
251540;SAO VICENTE DO SERIDO;5622;5297;10919;0,514882315;0,485117685
150200;CACHOEIRA DO ARARI;12540;11815;24355;0,514884007;0,485115993
291955;LUIS EDUARDO MAGALHAES;47715;44956;92671;0,514885995;0,485114005
421730;SAUDADES;5084;4790;9874;0,514887584;0,485112416
130070;BOCA DO ACRE;18000;16958;34958;0,514903599;0,485096401
430650;DOM FELICIANO;8010;7546;15556;0,51491386;0,48508614
351320;CRISTAIS PAULISTA;4533;4270;8803;0,514938089;0,485061911
311900;CORDISLANDIA;1826;1720;3546;0,514946418;0,485053582
521850;QUIRINOPOLIS;26429;24894;51323;0,514954309;0,485045691
410910;GUAPOREMA;1153;1086;2239;0,514962037;0,485037963
160050;OIAPOQUE;14694;13840;28534;0,514964604;0,485035396
310470;ATALEIA;6435;6061;12496;0,514964789;0,485035211
432067;SINIMBU;5228;4924;10152;0,514972419;0,485027581
353690;PEDRANOPOLIS;1271;1197;2468;0,514991896;0,485008104
510350;DIAMANTINO;11490;10821;22311;0,514992605;0,485007395
430265;BROCHIER;2643;2489;5132;0,515003897;0,484996103
510336;CONQUISTA D'OESTE;2144;2019;4163;0,515013212;0,484986788
355495;TUIUTI;3635;3423;7058;0,515018419;0,484981581
316180;SAO GONCALO DO PARA;6580;6196;12776;0,515028178;0,484971822
150800;TOME-ACU;33273;31331;64604;0,515030029;0,484969971
510685;PORTO ESTRELA;1439;1355;2794;0,515032212;0,484967788
150808;TUCUMA;20942;19719;40661;0,515038981;0,484961019
150510;OBIDOS;27026;25447;52473;0,515045833;0,484954167
210060;AMARANTE DO MARANHAO;21641;20376;42017;0,515053431;0,484946569
521410;MUTUNOPOLIS;1931;1818;3749;0,515070686;0,484929314
421917;VARGEM BONITA;2272;2139;4411;0,515075946;0,484924054
500580;NIOAQUE;7105;6689;13794;0,51507902;0,48492098
510642;PEIXOTO DE AZEVEDO;18386;17309;35695;0,515086147;0,484913853
240375;FERNANDO PEDROZA;1587;1494;3081;0,515092502;0,484907498
350980;CAMPOS NOVOS PAULISTA;2590;2438;5028;0,515115354;0,484884646
410680;CRUZ MACHADO;9670;9102;18772;0,515128915;0,484871085
170610;CRISTALANDIA;3744;3524;7268;0,515134838;0,484865162
170625;CRIXAS DO TOCANTINS;901;848;1749;0,515151515;0,484848485
315450;RIACHO DOS MACHADOS;4879;4592;9471;0,515151515;0,484848485
410500;CATANDUVAS;5226;4918;10144;0,515181388;0,484818612
160021;CUTIAS;3203;3014;6217;0,515200257;0,484799743
211102;SAO JOAO DO CARU;8124;7644;15768;0,5152207;0,4847793
150611;QUATIPURU;7107;6687;13794;0,51522401;0,48477599
290515;CAETANOS;7559;7112;14671;0,515234135;0,484765865
292090;MASCOTE;7017;6602;13619;0,515236067;0,484763933
110094;CUJUBIM;13979;13152;27131;0,515240868;0,484759132
315340;PRESIDENTE OLEGARIO;10140;9540;19680;0,515243902;0,484756098
421000;LUIZ ALVES;6877;6470;13347;0,515246872;0,484753128
292030;MALHADA DE PEDRAS;4290;4036;8326;0,515253423;0,484746577
291850;JUSSARA;7853;7388;15241;0,515254905;0,484745095
510345;DENISE;4960;4666;9626;0,515271141;0,484728859
220590;MANOEL EMIDIO;2758;2594;5352;0,515321375;0,484678625
420790;IRINEOPOLIS;5851;5503;11354;0,515324996;0,484675004
421960;XAVANTINA;1996;1877;3873;0,515362768;0,484637232
314420;NACIP RAYDAN;1660;1561;3221;0,515367898;0,484632102
353625;PARISI;1122;1055;2177;0,515388149;0,484611851
120060;TARAUACA;22538;21192;43730;0,515389893;0,484610107
292420;PEDRO ALEXANDRE;8606;8092;16698;0,515391065;0,484608935
510706;QUERENCIA;9476;8910;18386;0,515392146;0,484607854
431595;ROLADOR;1170;1100;2270;0,515418502;0,484581498
314970;PERDIGAO;6182;5812;11994;0,515424379;0,484575621
411050;IPIRANGA;7900;7427;15327;0,515430286;0,484569714
314900;PEDRA DOURADA;1319;1240;2559;0,515435717;0,484564283
314670;PALMA;3405;3201;6606;0,515440509;0,484559491
220045;ALVORADA DO GURGUEIA;2819;2650;5469;0,515450722;0,484549278
314345;MONTEZUMA;4319;4060;8379;0,515455305;0,484544695
220255;CARIDADE DO PIAUI;2630;2472;5102;0,515484124;0,484515876
354010;PONGAI;1745;1640;3385;0,515509601;0,484490399
313868;LUISLANDIA;3472;3263;6735;0,515515961;0,484484039
430965;HULHA NEGRA;3554;3340;6894;0,515520743;0,484479257
430517;CERRO GRANDE DO SUL;6485;6094;12579;0,515541776;0,484458224
150710;SAO CAETANO DE ODIVELAS;9387;8820;18207;0,515570934;0,484429066
311547;CATUTI;2549;2395;4944;0,515574434;0,484425566
510619;NOVA SANTA HELENA;1936;1819;3755;0,515579228;0,484420772
421920;VIDAL RAMOS;3259;3062;6321;0,515582977;0,484417023
312705;FRONTEIRA DOS VALES;2342;2200;4542;0,51563188;0,48436812
150285;CURUA;7619;7157;14776;0,51563346;0,48436654
353600;PARAPUA;5638;5296;10934;0,51563929;0,48436071
510270;CANARANA;11397;10704;22101;0,515678024;0,484321976
431849;SAO JOSE DO INHACORA;1052;988;2040;0,515686275;0,484313725
431445;PINHAL;1331;1250;2581;0,515691592;0,484308408
500600;NOVA ALVORADA DO SUL;11844;11123;22967;0,515696434;0,484303566
250375;CAJAZEIRINHAS;1659;1558;3217;0,515697855;0,484302145
240460;IELMO MARINHO;7237;6796;14033;0,515712962;0,484287038
351790;GUARACI;5870;5512;11382;0,515726586;0,484273414
313740;LAGOA DOURADA;6764;6351;13115;0,51574533;0,48425467
171110;ITAPORA DO TOCANTINS;1244;1168;2412;0,515754561;0,484245439
211240;TURIACU;18470;17341;35811;0,515763313;0,484236687
311790;CONGONHAL;6297;5912;12209;0,515767057;0,484232943
312710;FRUTAL;31209;29299;60508;0,515783037;0,484216963
150180;BREVES;53790;50490;104280;0,515822785;0,484177215
350930;CAJOBI;5493;5156;10649;0,515823082;0,484176918
290970;CRISTOPOLIS;7212;6769;13981;0,51584293;0,48415707
350890;CAIABU;2164;2031;4195;0,515852205;0,484147795
150770;SAO SEBASTIAO DA BOA VISTA;14085;13217;27302;0,515896271;0,484103729
314280;MONTE ALEGRE DE MINAS;11014;10335;21349;0,515902384;0,484097616
311950;CORONEL MURTA;4751;4458;9209;0,515908351;0,484091649
313870;LUMINARIAS;2802;2629;5431;0,515927085;0,484072915
315370;QUARTEL GERAL;1859;1744;3603;0,515958923;0,484041077
170389;CARRASCO BONITO;2149;2016;4165;0,515966387;0,484033613
230625;ITAITINGA;19948;18713;38661;0,515972168;0,484027832
260710;INGAZEIRA;2341;2196;4537;0,515979722;0,484020278
290660;CANDIBA;7438;6977;14415;0,515990288;0,484009712
330460;SANTA MARIA MADALENA;5356;5024;10380;0,515992293;0,484007707
316170;SAO GONCALO DO ABAETE;4400;4127;8527;0,516007975;0,483992025
430330;CAIBATE;2478;2324;4802;0,516034985;0,483965015
240530;JANUARIO CICCO;5350;5017;10367;0,516060577;0,483939423
315415;REDUTO;3740;3507;7247;0,516075617;0,483924383
313867;LUISBURGO;3225;3024;6249;0,516082573;0,483917427
171700;PINDORAMA DO TOCANTINS;2278;2136;4414;0,516085184;0,483914816
311480;CARVALHOS;2294;2151;4445;0,516085489;0,483914511
353550;PARAGUACU PAULISTA;23833;22347;46180;0,516089216;0,483910784
420315;CALMON;1716;1609;3325;0,516090226;0,483909774
421270;PETROLANDIA;3031;2842;5873;0,516090584;0,483909416
430585;COQUEIROS DO SUL;1170;1097;2267;0,516100573;0,483899427
311640;CLARAVAL;2515;2358;4873;0,516109173;0,483890827
241440;TOUROS;17402;16314;33716;0,516134773;0,483865227
510650;POCONE;17232;16154;33386;0,516144492;0,483855508
312240;DIVISA NOVA;3117;2922;6039;0,516145057;0,483854943
421715;SAO MIGUEL DA BOA VISTA;926;868;1794;0,516164994;0,483835006
352830;MAGDA;1593;1493;3086;0,516202203;0,483797797
150090;AUGUSTO CORREA;24229;22708;46937;0,516202569;0,483797431
421470;RIO DOS CEDROS;6162;5775;11937;0,516210103;0,483789897
120032;JORDAO;4454;4174;8628;0,51622624;0,48377376
500640;PEDRO GOMES;3907;3661;7568;0,516252643;0,483747357
120070;XAPURI;10256;9610;19866;0,516258935;0,483741065
420519;ERMO;1063;996;2059;0,516270034;0,483729966
314085;MATIAS CARDOSO;5865;5495;11360;0,516285211;0,483714789
510735;SAO JOSE DO XINGU;2915;2731;5646;0,516294722;0,483705278
290920;CORONEL JOAO SA;8028;7521;15549;0,516303299;0,483696701
354030;PONTES GESTAL;1330;1246;2576;0,516304348;0,483695652
350080;ALFREDO MARCONDES;2169;2032;4201;0,516305642;0,483694358
311290;CAPUTIRA;4811;4507;9318;0,516312513;0,483687487
355050;SAO PEDRO DO TURVO;3988;3736;7724;0,516312791;0,483687209
500124;ARAL MOREIRA;6460;6051;12511;0,516345616;0,483654384
421545;SANGAO;6779;6349;13128;0,516377209;0,483622791
291620;ITAPE;4286;4014;8300;0,516385542;0,483614458
311260;CAPINOPOLIS;8414;7880;16294;0,5163864;0,4836136
310760;BOM JESUS DA PENHA;2205;2065;4270;0,516393443;0,483606557
314440;NATERCIA;2441;2286;4727;0,516395177;0,483604823
230526;IBARETAMA;6912;6473;13385;0,516398954;0,483601046
431430;PEJUCARA;1983;1857;3840;0,51640625;0,48359375
290310;BARRA DO ROCHA;2848;2667;5515;0,516409791;0,483590209
312640;FORTUNA DE MINAS;1542;1444;2986;0,516409913;0,483590087
150275;CONCORDIA DO PARA;17680;16556;34236;0,516415469;0,483584531
314550;OLIMPIO NORONHA;1461;1368;2829;0,516436903;0,483563097
160053;PORTO GRANDE;11841;11086;22927;0,516465303;0,483534697
320013;AGUIA BRANCA;4969;4652;9621;0,516474379;0,483525621
313070;INDIANOPOLIS;3620;3389;7009;0,516478813;0,483521187
431055;ITACURUBI;1785;1671;3456;0,516493056;0,483506944
311270;CAPITAO ENEAS;7948;7440;15388;0,516506369;0,483493631
353040;MIRASSOLANDIA;2565;2401;4966;0,516512284;0,483487716
220930;SANTA LUZ;3049;2854;5903;0,516517025;0,483482975
316240;SAO JOAO DA PONTE;12930;12103;25033;0,516518196;0,483481804
313530;JAPARAIBA;2282;2136;4418;0,516523314;0,483476686
220080;ANTONIO ALMEIDA;1640;1535;3175;0,516535433;0,483464567
310120;AIURUOCA;3073;2876;5949;0,516557405;0,483442595
500510;JATEI;2074;1941;4015;0,516562889;0,483437111
160055;PRACUUBA;2774;2596;5370;0,516573557;0,483426443
316294;SAO JOSE DA BARRA;3891;3641;7532;0,516595858;0,483404142
421985;ZORTEA;1773;1659;3432;0,516608392;0,483391608
520753;FAINA;3372;3155;6527;0,516623257;0,483376743
150430;MARACANA;15271;14288;29559;0,516627761;0,483372239
313505;JAIBA;20588;19262;39850;0,51663739;0,48336261
510269;CANABRAVA DO NORTE;2434;2277;4711;0,516663129;0,483336871
312595;FERVEDOURO;5735;5365;11100;0,516666667;0,483333333
310100;AGUAS VERMELHAS;7056;6600;13656;0,516695958;0,483304042
291875;LAGOA REAL;8200;7670;15870;0,516698173;0,483301827
291180;GUARATINGA;10626;9939;20565;0,516703136;0,483296864
310650;BERILO;6104;5709;11813;0,516718869;0,483281131
317090;VARZELANDIA;9968;9322;19290;0,516744427;0,483255573
510623;NOVA OLIMPIA;10759;10061;20820;0,516762728;0,483237272
330570;SUMIDOURO;8118;7591;15709;0,516773824;0,483226176
313507;JAMPRUCA;2818;2635;5453;0,516779754;0,483220246
521880;RIO VERDE;127780;119479;247259;0,516786042;0,483213958
354090;PRADOPOLIS;11493;10746;22239;0,51679482;0,48320518
350830;CABRALIA PAULISTA;2182;2040;4222;0,516816675;0,483183325
510700;POXOREO;8236;7700;15936;0,516817269;0,483182731
130130;CODAJAS;15345;14346;29691;0,51682328;0,48317672
431725;SANTA TEREZA;890;832;1722;0,516840883;0,483159117
521630;PARANAIGUARA;5283;4938;10221;0,516877018;0,483122982
240840;OLHO-D'AGUA DO BORGES;2187;2044;4231;0,516899078;0,483100922
421507;RIQUEZA;2339;2186;4525;0,516906077;0,483093923
430925;GUABIJU;764;714;1478;0,51691475;0,48308525
150616;RIO MARIA;9412;8796;18208;0,516915641;0,483084359
412863;DOUTOR ULYSSES;2856;2669;5525;0,516923077;0,483076923
520357;BONOPOLIS;2367;2212;4579;0,516925093;0,483074907
150475;MOJUI DOS CAMPOS;8417;7865;16282;0,516951234;0,483048766
292665;RIBEIRAO DO LARGO;2531;2365;4896;0,516952614;0,483047386
430192;BARRA DO RIO AZUL;838;783;1621;0,516964837;0,483035163
500755;SANTA RITA DO PARDO;4109;3839;7948;0,516985405;0,483014595
410020;ADRIANOPOLIS;2997;2800;5797;0,516991547;0,483008453
352630;LAGOINHA;2524;2358;4882;0,517001229;0,482998771
510300;CHAPADA DOS GUIMARAES;11644;10877;22521;0,517028551;0,482971449
130060;BENJAMIN CONSTANT;23201;21672;44873;0,517036971;0,482963029
150497;NOVA IPIXUNA;8804;8223;17027;0,517061138;0,482938862
291870;LAFAIETE COUTINHO;1894;1769;3663;0,517062517;0,482937483
420810;ITAIOPOLIS;11318;10571;21889;0,517063365;0,482936635
353240;NAZARE PAULISTA;9755;9111;18866;0,517067741;0,482932259
411950;PIRAQUARA;60421;56431;116852;0,517072879;0,482927121
110020;PORTO VELHO;283850;265102;548952;0,517076174;0,482923826
500460;ITAQUIRAI;11171;10433;21604;0,51708017;0,48291983
510285;CASTANHEIRA;4541;4241;8782;0,517080392;0,482919608
311440;CARMO DO RIO CLARO;11019;10291;21310;0,517081183;0,482918817
171888;SANTA MARIA DO TOCANTINS;1829;1708;3537;0,517104891;0,482895109
315560;RIO PARDO DE MINAS;16119;15052;31171;0,517115267;0,482884733
353460;OSVALDO CRUZ;17126;15992;33118;0,517120599;0,482879401
520735;EDEALINA;1902;1776;3678;0,517128874;0,482871126
290250;BAIANOPOLIS;7229;6750;13979;0,517132842;0,482867158
130310;NOVA OLINDA DO NORTE;19995;18670;38665;0,517134359;0,482865641
317065;VARGEM GRANDE DO RIO PARDO;2609;2436;5045;0,517145689;0,482854311
315050;PIMENTA;4507;4208;8715;0,517154332;0,482845668
211080;SAO FELIX DE BALSAS;2348;2192;4540;0,517180617;0,482819383
310370;ARAPONGA;4379;4088;8467;0,517184363;0,482815637
150307;GARRAFAO DO NORTE;13527;12628;26155;0,517186006;0,482813994
355460;TIMBURI;1369;1278;2647;0,517189271;0,482810729
311010;CAIANA;2888;2696;5584;0,517191977;0,482808023
315810;SANTA MARIA DO SALTO;2691;2512;5203;0,517201614;0,482798386
431198;MARIANA PIMENTEL;2013;1879;3892;0,5172148;0,4827852
312960;IBIAI;4385;4093;8478;0,517221043;0,482778957
410115;ANGULO;1516;1415;2931;0,517229614;0,482770386
292490;PLANALTINO;4870;4545;9415;0,517259692;0,482740308
240165;BODO;1123;1048;2171;0,517273146;0,482726854
421490;RIO FORTUNA;2395;2235;4630;0,517278618;0,482721382
210280;CAROLINA;12493;11658;24151;0,517287069;0,482712931
352380;ITOBI;4067;3795;7862;0,517298397;0,482701603
241110;RUY BARBOSA;1854;1730;3584;0,517299107;0,482700893
150730;SAO FELIX DO XINGU;70216;65516;135732;0,51731353;0,48268647
150345;IPIXUNA DO PARA;34749;32421;67170;0,517329165;0,482670835
411230;JAPIRA;2550;2379;4929;0,517346318;0,482653682
350775;BREJO ALEGRE;1506;1405;2911;0,51734799;0,48265201
313695;JUVENILIA;2952;2754;5706;0,517350158;0,482649842
354480;SALES;3353;3128;6481;0,517358432;0,482641568
421625;SAO JOAO DO OESTE;3323;3100;6423;0,517359489;0,482640511
311450;CARMOPOLIS DE MINAS;10221;9535;19756;0,517361814;0,482638186
410865;GOIOXIM;3620;3377;6997;0,517364585;0,482635415
290440;BREJOLANDIA;5523;5152;10675;0,517377049;0,482622951
412015;PORTO BARREIRO;1621;1512;3133;0,517395468;0,482604532
110143;NOVA UNIAO;3530;3292;6822;0,517443565;0,482556435
310060;AGUA BOA;6892;6427;13319;0,517456265;0,482543735
210725;NOVA COLINAS;2830;2639;5469;0,517462059;0,482537941
312560;FELISBURGO;3906;3642;7548;0,517488076;0,482511924
430223;BOA VISTA DO INCRA;1360;1268;2628;0,517503805;0,482496195
432135;TAVARES;2838;2646;5484;0,51750547;0,48249453
353590;PARANAPUA;2128;1984;4112;0,517509728;0,482490272
210083;APICUM-ACU;9099;8483;17582;0,517517916;0,482482084
130430;URUCARA;8284;7723;16007;0,517523583;0,482476417
510520;JUSCIMEIRA;5757;5367;11124;0,517529666;0,482470334
500085;ANGELICA;5735;5346;11081;0,517552567;0,482447433
293325;VEREDA;3160;2945;6105;0,517608518;0,482391482
421070;MATOS COSTA;1264;1178;2442;0,517608518;0,482391482
430055;ALTO ALEGRE;823;767;1590;0,517610063;0,482389937
313150;IPUIUNA;5257;4899;10156;0,517625049;0,482374951
293075;SITIO DO MATO;6783;6321;13104;0,517628205;0,482371795
420325;CAPAO ALTO;1277;1190;2467;0,517632752;0,482367248
432035;SENTINELA DO SUL;2917;2718;5635;0,517657498;0,482342502
313652;JOSE GONCALVES DE MINAS;2316;2158;4474;0,517657577;0,482342423
421440;RIO DAS ANTAS;3209;2990;6199;0,517664139;0,482335861
521940;SANTA RITA DO ARAGUAIA;4716;4394;9110;0,517672887;0,482327113
315710;SALTO DA DIVISA;3631;3383;7014;0,517678928;0,482321072
150460;MOCAJUBA;16523;15394;31917;0,517686499;0,482313501
293350;WENCESLAU GUIMARAES;10800;10062;20862;0,517687662;0,482312338
130110;CAREIRO;20097;18723;38820;0,517697063;0,482302937
314980;PERDIZES;8526;7943;16469;0,517699921;0,482300079
110013;MACHADINHO D'OESTE;21602;20122;41724;0,517735596;0,482264404
412540;SAO JOSE DA BOA VISTA;3166;2949;6115;0,517743254;0,482256746
120050;SENA MADUREIRA;24421;22747;47168;0,517745081;0,482254919
500150;BANDEIRANTES;3770;3511;7281;0,517786018;0,482213982
150172;BRASIL NOVO;7707;7176;14883;0,517839145;0,482160855
312900;GUIRICEMA;4296;4000;8296;0,517839923;0,482160077
431177;MAQUINE;3494;3253;6747;0,51785979;0,48214021
150803;TRACUATEUA;16338;15211;31549;0,517861105;0,482138895
292840;SANTA RITA DE CASSIA;14818;13795;28613;0,51787649;0,48212351
430245;BOQUEIRAO DO LEAO;3983;3708;7691;0,517878039;0,482121961
315770;SANTA JULIANA;7508;6989;14497;0,517900255;0,482099745
210410;FORTALEZA DOS NOGUEIRAS;6558;6104;12662;0,517927658;0,482072342
251335;SANTA INES;1860;1731;3591;0,517961571;0,482038429
510325;COLNIZA;21298;19819;41117;0,517985262;0,482014738
315660;RUBIM;5320;4949;10269;0,518064076;0,481935924
510665;PONTAL DO ARAGUAIA;3612;3360;6972;0,518072289;0,481927711
354180;QUEIROZ;1820;1693;3513;0,518075719;0,481924281
211157;SAO PEDRO DOS CRENTES;2435;2265;4700;0,518085106;0,481914894
316430;SAO ROQUE DE MINAS;3679;3421;7100;0,518169014;0,481830986
354310;RIBEIRAO CORRENTE;2480;2306;4786;0,518178019;0,481821981
260130;BARRA DE GUABIRABA;7582;7050;14632;0,518179333;0,481820667
220955;SAO BRAZ DO PIAUI;2308;2146;4454;0,5181859;0,4818141
412620;SAPOPEMA;3476;3232;6708;0,518187239;0,481812761
292020;MALHADA;8745;8130;16875;0,518222222;0,481777778
353810;PINDORAMA;9006;8372;17378;0,518241455;0,481758545
314780;PASSA-VINTE;1049;975;2024;0,518280632;0,481719368
312950;IBIA;13223;12288;25511;0,518325428;0,481674572
314850;PAVAO;4349;4041;8390;0,518355185;0,481644815
313400;ITINGA;7803;7250;15053;0,518368432;0,481631568
290475;BURITIRAMA;11080;10294;21374;0,518386825;0,481613175
412788;TUNAS DO PARANA;4805;4464;9269;0,518394649;0,481605351
520017;AGUA FRIA DE GOIAS;3029;2814;5843;0,518398083;0,481601917
320510;VIANA;41855;38880;80735;0,518424475;0,481575525
510787;SAPEZAL;14249;13236;27485;0,518428234;0,481571766
290225;ARATACA;5653;5251;10904;0,518433602;0,481566398
292110;MEDEIROS NETO;11790;10951;22741;0,518446858;0,481553142
510558;MARCELANDIA;5240;4867;10107;0,518452558;0,481547442
150390;JURUTI;31087;28874;59961;0,518453662;0,481546338
520670;DAMIANOPOLIS;1712;1590;3302;0,518473652;0,481526348
520815;GAMELEIRA DE GOIAS;2034;1889;3923;0,518480755;0,481519245
292470;PIRIPA;5316;4937;10253;0,518482395;0,481517605
421140;NOVA ERECHIM;2677;2486;5163;0,518496998;0,481503002
130006;AMATURA;6188;5746;11934;0,518518519;0,481481481
431261;MUITOS CAPOES;1651;1533;3184;0,518530151;0,481469849
510850;VERA;6083;5648;11731;0,518540619;0,481459381
251430;SAO JOSE DE CAIANA;3316;3078;6394;0,518611198;0,481388802
411730;ORTIGUEIRA;11297;10486;21783;0,518615434;0,481384566
291110;FORMOSA DO RIO PRETO;13542;12569;26111;0,518631994;0,481368006
171510;NOVO ACORDO;2308;2142;4450;0,518651685;0,481348315
520250;ARUANA;5363;4977;10340;0,518665377;0,481334623
354280;RIBEIRA;1722;1598;3320;0,518674699;0,481325301
412385;SANTA MARIA DO OESTE;4777;4433;9210;0,518675353;0,481324647
251440;SAO JOSE DE ESPINHARAS;2402;2229;4631;0,518678471;0,481321529
520530;CAVALCANTE;5052;4688;9740;0,518685832;0,481314168
420970;LEBON REGIS;6288;5834;12122;0,518726283;0,481273717
520465;CAMPINACU;1882;1746;3628;0,518743109;0,481256891
292000;MAIQUINIQUE;5340;4954;10294;0,518748786;0,481251214
350820;BURITIZAL;2359;2188;4547;0,518803607;0,481196393
170600;COUTO MAGALHAES;2952;2738;5690;0,518804921;0,481195079
320517;VILA VALERIO;7297;6768;14065;0,518805546;0,481194454
292305;NOVO TRIUNFO;8013;7432;15445;0,518808676;0,481191324
292045;MANSIDAO;7171;6651;13822;0,518810592;0,481189408
352300;ITAPURA;2591;2403;4994;0,518822587;0,481177413
251410;SAO JOAO DO TIGRE;2287;2121;4408;0,518829401;0,481170599
313360;ITAPEVA;5176;4800;9976;0,518845229;0,481154771
355550;UBIRAJARA;2505;2323;4828;0,518848384;0,481151616
421775;SUL BRASIL;1238;1148;2386;0,518860017;0,481139983
320435;RIO BANANAL;10065;9333;19398;0,518867925;0,481132075
291280;IBIRAPUA;4535;4205;8740;0,518878719;0,481121281
352885;MARAPOAMA;1607;1490;3097;0,518889248;0,481110752
312120;DELFINOPOLIS;3708;3438;7146;0,518891688;0,481108312
171620;PARANA;5410;5016;10426;0,51889507;0,48110493
431447;PINHAL GRANDE;2236;2073;4309;0,518913901;0,481086099
313710;LAGAMAR;3938;3650;7588;0,518977333;0,481022667
311850;CONSOLACAO;927;859;1786;0,519036954;0,480963046
520640;CRIXAS;8895;8241;17136;0,519082633;0,480917367
432026;SEGREDO;3875;3590;7465;0,519089082;0,480910918
355635;VARGEM;5628;5214;10842;0,519092418;0,480907582
210598;LAJEADO NOVO;3973;3680;7653;0,51914282;0,48085718
291260;IBIQUERA;2101;1946;4047;0,519149988;0,480850012
431515;PROGRESSO;3237;2998;6235;0,519165998;0,480834002
510035;ALTO BOA VISTA;3682;3410;7092;0,519176537;0,480823463
510523;LAMBARI D'OESTE;3243;3003;6246;0,519212296;0,480787704
510279;CARLINDA;5241;4853;10094;0,519219338;0,480780662
420340;CAMPO BELO DO SUL;3577;3312;6889;0,519233561;0,480766439
412780;TOMAZINA;3998;3701;7699;0,519288219;0,480711781
314920;PEDRINOPOLIS;1896;1755;3651;0,519309778;0,480690222
171380;PALMEIRAS DO TOCANTINS;3547;3283;6830;0,519326501;0,480673499
310925;BUGRE;2069;1915;3984;0,519327309;0,480672691
521375;MONTIVIDIU;7237;6698;13935;0,519339792;0,480660208
150563;PICARRA;6739;6237;12976;0,519343403;0,480656597
520590;CORUMBAIBA;5200;4812;10012;0,519376748;0,480623252
150797;TERRA SANTA;9901;9162;19063;0,519383098;0,480616902
130300;NHAMUNDA;11276;10434;21710;0,519391985;0,480608015
430843;FORQUETINHA;1241;1148;2389;0,519464211;0,480535789
421915;VARGEM;1240;1147;2387;0,519480519;0,480519481
421590;SAO BONIFACIO;1450;1341;2791;0,519527051;0,480472949
313020;IGARATINGA;5791;5355;11146;0,519558586;0,480441414
431070;ITATIBA DO SUL;1633;1510;3143;0,519567292;0,480432708
210430;GODOFREDO VIANA;6289;5815;12104;0,519580304;0,480419696
172030;SAO SEBASTIAO DO TOCANTINS;2545;2353;4898;0,519599837;0,480400163
150747;SAO JOAO DE PIRABAS;12180;11260;23440;0,519624573;0,480375427
240185;CAICARA DO NORTE;3415;3157;6572;0,519628728;0,480371272
210407;FEIRA NOVA DO MARANHAO;4420;4086;8506;0,5196332;0,4803668
220785;PAVUSSU;1903;1759;3662;0,519661387;0,480338613
210920;PRESIDENTE JUSCELINO;6724;6215;12939;0,519669217;0,480330783
320115;BREJETUBA;6470;5980;12450;0,519678715;0,480321285
430957;HERVEIRAS;1569;1450;3019;0,519708513;0,480291487
170105;ANGICO;1806;1669;3475;0,51971223;0,48028777
430511;CENTENARIO;1489;1376;2865;0,519720768;0,480279232
171890;SANTA ROSA DO TOCANTINS;2528;2336;4864;0,519736842;0,480263158
211180;SITIO NOVO;9479;8758;18237;0,519767506;0,480232494
315445;RIACHINHO;4227;3905;8132;0,519798328;0,480201672
210620;LUIS DOMINGUES;3647;3369;7016;0,519811859;0,480188141
315940;SANTA RITA DE IBITIPOCA;1757;1623;3380;0,519822485;0,480177515
350540;BARRA DO TURVO;3954;3652;7606;0,519852748;0,480147252
313657;JOSENOPOLIS;2553;2358;4911;0,51985339;0,48014661
431213;MATO CASTELHANO;1322;1221;2543;0,519858435;0,480141565
313650;JORDANIA;5652;5220;10872;0,51986755;0,48013245
354570;SANTA ALBERTINA;3138;2898;6036;0,519880716;0,480119284
316225;SAO JOAO DA LAGOA;2573;2376;4949;0,519903011;0,480096989
150013;ABEL FIGUEIREDO;3918;3618;7536;0,519904459;0,480095541
521690;PILAR DE GOIAS;1110;1025;2135;0,519906323;0,480093677
420445;CORONEL MARTINS;1331;1229;2560;0,519921875;0,480078125
351170;CHARQUEADA;9119;8420;17539;0,51992702;0,48007298
520990;IACIARA;7391;6824;14215;0,519943721;0,480056279
411870;PAULO FRONTIN;3857;3561;7418;0,519951469;0,480048531
352760;LUIS ANTONIO;8126;7502;15628;0,519964167;0,480035833
315280;PRATA;14650;13523;28173;0,52000142;0,47999858
313470;JACINTO;6407;5913;12320;0,520048701;0,479951299
351160;CESARIO LANGE;9671;8924;18595;0,520086045;0,479913955
430915;GRAMADO XAVIER;2277;2101;4378;0,520100503;0,479899497
210409;FORMOSA DA SERRA NEGRA;10103;9322;19425;0,52010296;0,47989704
170330;BOM JESUS DO TOCANTINS;2663;2457;5120;0,520117188;0,479882813
421315;PLANALTO ALEGRE;1512;1395;2907;0,520123839;0,479876161
150590;PORTO DE MOZ;22083;20373;42456;0,520138496;0,479861504
251675;TENORIO;1614;1489;3103;0,520141798;0,479858202
292540;POTIRAGUA;3445;3178;6623;0,520157029;0,479842971
354440;RUBIACEA;1662;1533;3195;0,520187793;0,479812207
353500;PALESTINA;6911;6374;13285;0,520210764;0,479789236
210905;PORTO RICO DO MARANHAO;3088;2848;5936;0,520215633;0,479784367
520915;GOUVELANDIA;3161;2915;6076;0,520243581;0,479756419
172210;XAMBIOA;5983;5517;11500;0,52026087;0,47973913
432360;VISTA ALEGRE DO PRATA;808;745;1553;0,520283323;0,479716677
431755;SANTO ANTONIO DO PALMA;1102;1016;2118;0,520302172;0,479697828
420110;ANITAPOLIS;1677;1546;3223;0,520322681;0,479677319
420419;CHAPADAO DO LAGEADO;1574;1451;3025;0,520330579;0,479669421
313260;ITAMARATI DE MINAS;2287;2108;4395;0,52036405;0,47963595
220115;BAIXA GRANDE DO RIBEIRO;6115;5636;11751;0,520381244;0,479618756
293090;TABOCAS DO BREJO VELHO;6513;6002;12515;0,520415501;0,479584499
291735;JABORANDI;4255;3921;8176;0,520425636;0,479574364
355190;SEVERINIA;9275;8545;17820;0,520482604;0,479517396
521310;MINEIROS;36163;33314;69477;0,520503188;0,479496812
211285;VILA NOVA DOS MARTIRIOS;7183;6617;13800;0,520507246;0,479492754
250550;VISTA SERRANA;2004;1846;3850;0,520519481;0,479480519
160005;SERRA DO NAVIO;2903;2674;5577;0,520530751;0,479469249
315380;QUELUZITO;1014;934;1948;0,520533881;0,479466119
522050;SERRANOPOLIS;4548;4189;8737;0,520544809;0,479455191
351530;ESTRELA DO NORTE;1444;1330;2774;0,520547945;0,479452055
510617;NOVA NAZARE;2089;1924;4013;0,520558186;0,479441814
420285;BRACO DO TROMBUDO;1975;1819;3794;0,520558777;0,479441223
220173;BETANIA DO PIAUI;3235;2979;6214;0,520598648;0,479401352
314250;MONJOLOS;1137;1047;2184;0,520604396;0,479395604
170900;GOIATINS;6856;6313;13169;0,5206166;0,4793834
354790;SANTO ANTONIO DA ALEGRIA;3657;3367;7024;0,520643508;0,479356492
310790;BOM REPOUSO;5481;5046;10527;0,520661157;0,479338843
317075;VARJAO DE MINAS;3767;3468;7235;0,520663442;0,479336558
240970;PEDRO AVELINO;3432;3159;6591;0,520710059;0,479289941
520020;AGUA LIMPA;942;867;1809;0,520729685;0,479270315
355520;TURIUBA;1054;970;2024;0,520750988;0,479249012
350230;ANHEMBI;3599;3312;6911;0,520763999;0,479236001
510360;DOM AQUINO;4212;3875;8087;0,520835909;0,479164091
350720;BORA;437;402;839;0,520858164;0,479141836
280110;CANHOBA;2085;1918;4003;0,520859355;0,479140645
500390;FIGUEIRAO;1597;1469;3066;0,520874103;0,479125897
241335;SERRA DO MEL;6368;5857;12225;0,520899796;0,479100204
314545;OLHOS-D'AGUA;3252;2991;6243;0,520903412;0,479096588
313730;LAGOA DOS PATOS;2116;1946;4062;0,520925652;0,479074348
432132;TAQUARUCU DO SUL;1605;1476;3081;0,520934761;0,479065239
160080;VITORIA DO JARI;8633;7939;16572;0,520938933;0,479061067
352490;JAMBEIRO;3557;3271;6828;0,520943175;0,479056825
260775;ITAPISSUMA;14142;13002;27144;0,520999116;0,479000884
510170;BARRA DO BUGRES;18570;17072;35642;0,521014533;0,478985467
312990;IBITIURA DE MINAS;1822;1675;3497;0,521018015;0,478981985
170390;CASEARA;2873;2641;5514;0,521037359;0,478962641
261440;SOLIDAO;3144;2890;6034;0,521047398;0,478952602
150070;ANAJAS;15679;14412;30091;0,521052806;0,478947194
315040;PIEDADE DOS GERAIS;2623;2411;5034;0,521056814;0,478943186
311995;CORREGO FUNDO;3348;3077;6425;0,521089494;0,478910506
120013;BUJARI;5509;5063;10572;0,521093454;0,478906546
150490;MUANA;21602;19852;41454;0,521107734;0,478892266
500325;COSTA RICA;11181;10275;21456;0,521112975;0,478887025
314300;MONTE BELO;6847;6292;13139;0,521120329;0,478879671
510390;GENERAL CARNEIRO;2984;2742;5726;0,52113168;0,47886832
351930;IBATE;18673;17157;35830;0,521155456;0,478844544
240820;NISIA FLORESTA;14732;13534;28266;0,521191538;0,478808462
520085;AMERICANO DO BRASIL;3242;2978;6220;0,521221865;0,478778135
250057;ALGODAO DE JANDAIRA;1349;1239;2588;0,521251932;0,478748068
315090;PIRANGUCU;2869;2635;5504;0,521257267;0,478742733
421189;PAINEL;1226;1126;2352;0,521258503;0,478741497
130050;BARREIRINHA;17160;15759;32919;0,521279504;0,478720496
430205;BENJAMIN CONSTANT DO SUL;1003;921;1924;0,521309771;0,478690229
351385;DIRCE REIS;941;864;1805;0,52132964;0,47867036
320465;SAO DOMINGOS DO NORTE;4554;4181;8735;0,521350887;0,478649113
432183;TRES FORQUILHAS;1378;1265;2643;0,521377223;0,478622777
314875;PEDRA BONITA;3732;3425;7157;0,521447534;0,478552466
210500;HUMBERTO DE CAMPOS;15197;13946;29143;0,52146313;0,47853687
520725;DOVERLANDIA;3741;3433;7174;0,521466406;0,478533594
352110;IPEUNA;4080;3744;7824;0,521472393;0,478527607
210408;FERNANDO FALCAO;5507;5052;10559;0,521545601;0,478454399
312810;GUAPE;7442;6827;14269;0,521550214;0,478449786
291040;ENCRUZILHADA;8300;7614;15914;0,521553349;0,478446651
522155;TURVELANDIA;2841;2606;5447;0,521571507;0,478428493
130200;ITAPIRANGA;4857;4455;9312;0,521585052;0,478414948
312247;DOM BOSCO;1896;1739;3635;0,521595598;0,478404402
510620;NOVA BRASILANDIA;1907;1749;3656;0,521608315;0,478391685
316440;SAO SEBASTIAO DA BELA VISTA;2920;2678;5598;0,521614862;0,478385138
353970;PLATINA;1881;1725;3606;0,521630616;0,478369384
510621;NOVA CANAA DO NORTE;6717;6159;12876;0,52166822;0,47833178
520420;CACHOEIRA DE GOIAS;697;639;1336;0,521706587;0,478293413
421410;PRESIDENTE NEREU;1189;1090;2279;0,521720053;0,478279947
210203;BOM JESUS DAS SELVAS;18310;16785;35095;0,521726742;0,478273258
130240;LABREA;24879;22806;47685;0,521736395;0,478263605
311100;CAMPESTRE;10984;10068;21052;0,521755653;0,478244347
170650;DARCINOPOLIS;3261;2989;6250;0,52176;0,47824
431406;PASSA SETE;3021;2769;5790;0,521761658;0,478238342
312700;FRONTEIRA;9844;9022;18866;0,521785222;0,478214778
353680;PEDRA BELA;3197;2930;6127;0,521788804;0,478211196
412210;RIO BOM;1650;1512;3162;0,521821632;0,478178368
316730;SILVEIRANIA;1183;1084;2267;0,521835024;0,478164976
316245;SAO JOAO DAS MISSOES;6905;6327;13232;0,521840992;0,478159008
320515;VILA PAVAO;4843;4437;9280;0,521875;0,478125
353640;PAULICEIA;3935;3605;7540;0,521883289;0,478116711
171280;MAURILANDIA DO TOCANTINS;1811;1659;3470;0,521902017;0,478097983
310850;BOTUMIRIM;3267;2992;6259;0,521968366;0,478031634
350360;AREIOPOLIS;5839;5347;11186;0,521991775;0,478008225
313590;JESUANIA;2492;2282;4774;0,521994135;0,478005865
521525;NOVO PLANALTO;2397;2195;4592;0,521994774;0,478005226
241025;PORTO DO MANGUE;3448;3157;6605;0,522028766;0,477971234
292620;RIACHAO DAS NEVES;11657;10673;22330;0,522033139;0,477966861
130390;SAO PAULO DE OLIVENCA;21319;19518;40837;0,522051081;0,477948919
315760;SANTA FE DE MINAS;1987;1819;3806;0,522070415;0,477929585
160010;AMAPA;4837;4428;9265;0,522072315;0,477927685
240060;ALMINO AFONSO;2446;2239;4685;0,522091782;0,477908218
150293;DOM ELISEU;31958;29248;61206;0,522138352;0,477861648
171050;ITACAJA;3901;3570;7471;0,522152322;0,477847678
120038;PLACIDO DE CASTRO;10520;9627;20147;0,522162109;0,477837891
130115;CAREIRO DA VARZEA;16427;15032;31459;0,522171716;0,477828284
412470;SAO JERONIMO DA SERRA;5790;5298;11088;0,522186147;0,477813853
110070;CAMPO NOVO DE RONDONIA;7515;6876;14391;0,522201376;0,477798624
411729;NOVO ITACOLOMI;1481;1355;2836;0,522214386;0,477785614
110110;ITAPUA DO OESTE;5650;5169;10819;0,522229411;0,477770589
420610;GRAO PARA;3458;3163;6621;0,522277602;0,477722398
211178;SERRANO DO MARANHAO;5402;4941;10343;0,522285604;0,477714396
431973;SAO VALERIO DO SUL;1427;1305;2732;0,522327965;0,477672035
130320;NOVO AIRAO;10653;9742;20395;0,522333905;0,477666095
310825;BONITO DE MINAS;6008;5494;11502;0,52234394;0,47765606
210237;CACHOEIRA GRANDE;4975;4549;9524;0,522364553;0,477635447
412200;RIO AZUL;8062;7371;15433;0,522387093;0,477612907
160023;FERREIRA GOMES;4258;3893;8151;0,522389891;0,477610109
312660;FRANCISCO DUMONT;2752;2516;5268;0,522399393;0,477600607
354950;SAO JOSE DA BELA VISTA;4697;4294;8991;0,5224113;0,4775887
150520;OEIRAS DO PARA;17335;15847;33182;0,522421795;0,477578205
140045;PACARAIMA;10505;9603;20108;0,522428884;0,477571116
172130;TUPIRATINS;1455;1330;2785;0,522441652;0,477558348
150190;BUJARU;15526;14191;29717;0,522461891;0,477538109
320450;SANTA LEOPOLDINA;6359;5812;12171;0,522471449;0,477528551
120030;FEIJO;18280;16706;34986;0,522494712;0,477505288
432045;SERIO;987;902;1889;0,522498677;0,477501323
431795;SANTO EXPEDITO DO SUL;1195;1092;2287;0,522518583;0,477481417
430885;GENTIL;846;773;1619;0,522544781;0,477455219
150619;RUROPOLIS;27421;25052;52473;0,522573514;0,477426486
170307;BARRA DO OURO;2442;2231;4673;0,522576503;0,477423497
317107;VEREDINHA;2996;2737;5733;0,522588523;0,477411477
431344;NOVO TIRADENTES;1144;1045;2189;0,522613065;0,477386935
251260;QUIXABA;1050;959;2009;0,522648084;0,477351916
310410;ARCEBURGO;5744;5246;10990;0,522656961;0,477343039
241445;TRIUNFO POTIGUAR;1670;1525;3195;0,522691706;0,477308294
316420;SAO ROMAO;6645;6068;12713;0,522693306;0,477306694
410130;ANTONIO OLINTO;3879;3542;7421;0,522705835;0,477294165
330360;PARACAMBI;27755;25338;53093;0,522761946;0,477238054
291845;JUCURUCU;4630;4226;8856;0,522809395;0,477190605
315980;SANTA VITORIA;10455;9542;19997;0,522828424;0,477171576
510682;PORTO ESPERIDIAO;6366;5810;12176;0,5228318;0,4771682
312910;GURINHATA;2884;2632;5516;0,52284264;0,47715736
130020;ATALAIA DO NORTE;10911;9957;20868;0,522857964;0,477142036
290140;ANGICAL;7270;6632;13902;0,522946339;0,477053661
210180;BENEDITO LEITE;2951;2692;5643;0,522948786;0,477051214
280380;MALHADA DOS BOIS;1943;1772;3715;0,523014805;0,476985195
430655;DOM PEDRO DE ALCANTARA;1318;1202;2520;0,523015873;0,476984127
312330;DORES DO TURVO;2198;2004;4202;0,523084246;0,476915754
430187;BARRA DO QUARAI;2217;2021;4238;0,523124115;0,476875885
310310;ANTONIO PRADO DE MINAS;825;752;1577;0,523145212;0,476854788
432218;TUPANCI DO SUL;757;690;1447;0,523151348;0,476848652
420213;BELA VISTA DO TOLDO;3341;3045;6386;0,523175697;0,476824303
432335;VILA LANGARO;1083;987;2070;0,523188406;0,476811594
150495;NOVA ESPERANCA DO PIRIA;11259;10260;21519;0,523212045;0,476787955
316760;SIMONESIA;10378;9456;19834;0,523242916;0,476757084
170820;FORMOSO DO ARAGUAIA;9606;8752;18358;0,523259614;0,476740386
314795;PATIS;3156;2875;6031;0,523296302;0,476703698
421790;TANGARA;4526;4122;8648;0,523358002;0,476641998
520505;CASTELANDIA;1769;1611;3380;0,523372781;0,476627219
231355;TURURU;8683;7905;16588;0,523450687;0,476549313
354720;SANTANA DA PONTE PENSA;758;690;1448;0,523480663;0,476519337
521130;ITARUMA;3841;3496;7337;0,523510972;0,476489028
351490;ELIAS FAUSTO;9473;8622;18095;0,523514783;0,476485217
170384;CAMPOS LINDOS;5500;5005;10505;0,523560209;0,476439791
310855;BRASILANDIA DE MINAS;8876;8074;16950;0,523657817;0,476342183
432215;TUNAS;2401;2184;4585;0,523664122;0,476335878
410950;GUARAQUECABA;3956;3598;7554;0,523696055;0,476303945
352215;ITAOCA;1745;1587;3332;0,523709484;0,476290516
354765;SANTA SALETE;816;742;1558;0,523748395;0,476251605
311890;CORDISBURGO;4663;4240;8903;0,523756037;0,476243963
313005;ICARAI DE MINAS;6390;5810;12200;0,523770492;0,476229508
130423;TONANTINS;9972;9066;19038;0,523794516;0,476205484
171488;NOVA OLINDA;6293;5721;12014;0,52380556;0,47619444
220130;BARREIRAS DO PIAUI;1758;1598;3356;0,523837902;0,476162098
310945;CABECEIRA GRANDE;3680;3345;7025;0,523843416;0,476156584
130395;SAO SEBASTIAO DO UATUMA;7689;6989;14678;0,523845211;0,476154789
431125;LAGOAO;3389;3080;6469;0,523883135;0,476116865
316080;SAO BENTO ABADE;2835;2576;5411;0,52393273;0,47606727
171195;LAGOA DO TOCANTINS;2342;2128;4470;0,52393736;0,47606264
120039;PORTO WALTER;6548;5949;12497;0,523965752;0,476034248
315530;RIO MANSO;3104;2820;5924;0,52397029;0,47602971
353400;ONDA VERDE;2338;2124;4462;0,523980278;0,476019722
410030;AGUDOS DO SUL;5013;4554;9567;0,523988711;0,476011289
314520;NOVA SERRANA;56727;51514;108241;0,524080524;0,475919476
411140;IVAI;7363;6686;14049;0,524094242;0,475905758
430544;CHUVISCA;2892;2626;5518;0,524102936;0,475897064
411545;MARQUINHO;2245;2038;4283;0,524165305;0,475834695
130270;MANICORE;30090;27315;57405;0,524170368;0,475829632
130083;CAAPIRANGA;7067;6415;13482;0,524180389;0,475819611
312245;DIVISOPOLIS;5974;5422;11396;0,524219024;0,475780976
315727;SANTA BARBARA DO MONTE VERDE;1684;1528;3212;0,524283935;0,475716065
150830;VISEU;32555;29538;62093;0,524294204;0,475705796
420209;BARRA BONITA;852;773;1625;0,524307692;0,475692308
150470;MOJU;44176;40075;84251;0,52433799;0,47566201
420475;CUNHATAI;1034;938;1972;0,524340771;0,475659229
150175;BREJO GRANDE DO ARAGUAIA;3858;3499;7357;0,524398532;0,475601468
510780;SANTO ANTONIO DO LEVERGER;9014;8174;17188;0,524435653;0,475564347
150618;RONDON DO PARA;27926;25316;53242;0,524510725;0,475489275
316580;SENADOR JOSE BENTO;746;676;1422;0,524613221;0,475386779
171750;PIUM;4108;3722;7830;0,524648787;0,475351213
310130;ALAGOA;1394;1263;2657;0,524651863;0,475348137
221095;TAMBORIL DO PIAUI;1542;1397;2939;0,524668255;0,475331745
310070;AGUA COMPRIDA;1042;944;1986;0,524672709;0,475327291
171650;PEDRO AFONSO;7327;6637;13964;0,524706388;0,475293612
410315;BOM JESUS DO SUL;1822;1650;3472;0,524769585;0,475230415
130290;MAUES;34721;31438;66159;0,524811439;0,475188561
316150;SAO GERALDO;6692;6059;12751;0,524821583;0,475178417
354550;SANDOVALINA;2312;2093;4405;0,524858116;0,475141884
130030;AUTAZES;21522;19483;41005;0,524862822;0,475137178
210095;ARAME;17229;15596;32825;0,524874334;0,475125666
171525;NOVO JARDIM;1453;1315;2768;0,524927746;0,475072254
410395;CAMPINA DO SIMAO;2011;1820;3831;0,524928217;0,475071783
315057;PINTOPOLIS;3958;3582;7540;0,524933687;0,475066313
354510;SALMOURAO;2820;2552;5372;0,524944155;0,475055845
351190;CLEMENTINA;4669;4225;8894;0,524960648;0,475039352
312650;FRANCISCO BADARO;5413;4898;10311;0,524973329;0,475026671
290940;COTEGIPE;7222;6534;13756;0,52500727;0,47499273
291900;LAJEDINHO;1961;1774;3735;0,525033467;0,474966533
130063;BERURI;10765;9738;20503;0,525045115;0,474954885
521300;MAURILANDIA;7649;6919;14568;0,525054915;0,474945085
510680;PORTO DOS GAUCHOS;2806;2538;5344;0,52507485;0,47492515
316740;SILVIANOPOLIS;3286;2972;6258;0,525087888;0,474912112
312965;IBIRACATU;2804;2536;5340;0,525093633;0,474906367
314130;MEDEIROS;2028;1833;3861;0,525252525;0,474747475
311520;CONCEICAO DA BARRA DE MINAS;2069;1870;3939;0,525260218;0,474739782
315737;SANTA CRUZ DE SALINAS;2140;1934;4074;0,525282278;0,474717722
510140;ARIPUANA;12117;10950;23067;0,525295877;0,474704123
171180;JUARINA;1142;1032;2174;0,525298988;0,474701012
292225;MUQUEM DE SAO FRANCISCO;6030;5449;11479;0,525307082;0,474692918
120035;MARECHAL THAUMATURGO;10363;9364;19727;0,525320627;0,474679373
420680;IBICARE;1657;1497;3154;0,525364616;0,474635384
510525;LUCAS DO RIO VERDE;36607;33064;69671;0,525426648;0,474573352
150400;LIMOEIRO DO AJURU;15565;14058;29623;0,525436316;0,474563684
320225;GOVERNADOR LINDENBERG;6856;6191;13047;0,525484786;0,474515214
430175;BARAO DO TRIUNFO;3968;3582;7550;0,525562914;0,474437086
313865;LONTRA;5133;4633;9766;0,525599017;0,474400983
293345;WANDERLEY;6373;5752;12125;0,525608247;0,474391753
352890;MARIAPOLIS;2154;1944;4098;0,525622255;0,474377745
430107;ARROIO DO PADRE;1559;1407;2966;0,525623736;0,474376264
130160;FONTE BOA;8625;7784;16409;0,525626181;0,474373819
291000;DARIO MEIRA;5439;4908;10347;0,525659611;0,474340389
315870;SANTANA DO GARAMBEU;1311;1183;2494;0,525661588;0,474338412
520750;ESTRELA DO NORTE;1710;1543;3253;0,525668614;0,474331386
130170;HUMAITA;30066;27129;57195;0,525675321;0,474324679
420980;LEOBERTO LEAL;1556;1404;2960;0,525675676;0,474324324
130080;BORBA;22251;20077;42328;0,525680401;0,474319599
292145;MIRANTE;4345;3919;8264;0,525774443;0,474225557
171550;OLIVEIRA DE FATIMA;591;533;1124;0,525800712;0,474199288
510615;NOVA BANDEIRANTES;8441;7611;16052;0,525853476;0,474146524
221035;SAO LOURENCO DO PIAUI;2409;2172;4581;0,525867714;0,474132286
312620;FORMOSO;5159;4651;9810;0,525891947;0,474108053
313545;JENIPAPO DE MINAS;4092;3689;7781;0,525896414;0,474103586
221062;SEBASTIAO BARROS;1806;1628;3434;0,525917298;0,474082702
355695;VITORIA BRASIL;974;878;1852;0,525917927;0,474082073
310910;BUENO BRANDAO;5776;5206;10982;0,525951557;0,474048443
170410;CENTENARIO;1560;1406;2966;0,52596089;0,47403911
431647;SALVADOR DAS MISSOES;1438;1296;2734;0,525969276;0,474030724
432149;TOROPI;1448;1305;2753;0,525971667;0,474028333
150506;NOVO REPARTIMENTO;41283;37205;78488;0,525978494;0,474021506
355570;UNIAO PAULISTA;992;894;1886;0,525980912;0,474019088
150295;ELDORADO DOS CARAJAS;17923;16146;34069;0,526079427;0,473920573
130400;SILVES;4887;4402;9289;0,526106147;0,473893853
316830;TAQUARACU DE MINAS;2168;1952;4120;0,526213592;0,473786408
430593;CORONEL PILAR;843;759;1602;0,526217228;0,473782772
150280;CURRALINHO;18697;16833;35530;0,526231354;0,473768646
521645;PEROLANDIA;1661;1495;3156;0,526299113;0,473700887
314675;PALMOPOLIS;2735;2461;5196;0,526366436;0,473633564
312350;DOURADOQUARA;1008;907;1915;0,526370757;0,473629243
312480;ESTRELA DO SUL;4241;3816;8057;0,526374581;0,473625419
210317;CENTRO NOVO DO MARANHAO;11610;10446;22056;0,526387378;0,473612622
521971;SANTO ANTONIO DA BARRA;2572;2314;4886;0,526401965;0,473598035
420665;GUATAMBU;2470;2222;4692;0,526427962;0,473572038
421680;SAO JOSE DO CERRITO;4240;3814;8054;0,526446486;0,473553514
520350;BOM JESUS DE GOIAS;13724;12345;26069;0,526449039;0,473550961
130440;URUCURITUBA;12687;11411;24098;0,526475226;0,473524774
315650;RUBELITA;2953;2656;5609;0,526475308;0,473524692
170830;GOIANORTE;2704;2432;5136;0,526479751;0,473520249
170460;CHAPADA DE AREIA;745;670;1415;0,526501767;0,473498233
292070;MARAU;10880;9784;20664;0,526519551;0,473480449
431862;SAO JOSE DOS AUSENTES;1874;1685;3559;0,526552402;0,473447598
430465;CAPAO DO CIPO;1972;1773;3745;0,526568758;0,473431242
351495;EMBAUBA;1288;1158;2446;0,526573998;0,473426002
210173;BELAGUA;3995;3591;7586;0,526627999;0,473372001
353960;PLANALTO;2828;2542;5370;0,526629423;0,473370577
510785;SAO FELIX DO ARAGUAIA;6285;5649;11934;0,526646556;0,473353444
412510;SAO JOAO DO TRIUNFO;8089;7270;15359;0,526661892;0,473338108
520082;AMARALINA;2041;1834;3875;0,526709677;0,473290323
355270;TABATINGA;8842;7945;16787;0,526717103;0,473282897
431057;ITAPUCA;1073;964;2037;0,526755032;0,473244968
241350;SERRINHA;3228;2900;6128;0,526762402;0,473237598
150720;SAO DOMINGOS DO CAPIM;17007;15278;32285;0,526777141;0,473222859
220535;JOAO COSTA;1582;1421;3003;0,526806527;0,473193473
431478;PONTE PRETA;791;710;1501;0,526982012;0,473017988
130356;RIO PRETO DA EVA;18369;16487;34856;0,526996787;0,473003213
150543;OURILANDIA DO NORTE;17829;16002;33831;0,527001862;0,472998138
130002;ALVARAES;8641;7755;16396;0,527018785;0,472981215
421575;SAO BERNARDINO;1180;1059;2239;0,527020992;0,472979008
315970;SANTA ROSA DA SERRA;1773;1591;3364;0,52705113;0,47294887
316390;SAO PEDRO DA UNIAO;2405;2158;4563;0,527065527;0,472934473
510590;NOBRES;8081;7251;15332;0,527067571;0,472932429
431113;JARI;1830;1642;3472;0,527073733;0,472926267
150815;URUARA;23929;21466;45395;0,527128538;0,472871462
313890;MACHACALIS;3749;3363;7112;0,527137233;0,472862767
431540;REDENTORA;6211;5571;11782;0,527160075;0,472839925
522070;SITIO D'ABADIA;1603;1437;3040;0,527302632;0,472697368
316910;TOLEDO;3341;2995;6336;0,527304293;0,472695707
110008;COSTA MARQUES;10154;9101;19255;0,527343547;0,472656453
350535;BARRA DO CHAPEU;3056;2738;5794;0,527442182;0,472557818
352920;MARTINOPOLIS;14134;12657;26791;0,527565227;0,472434773
315300;PRATINHA;1930;1728;3658;0,527610716;0,472389284
421187;PAIAL;762;682;1444;0,527700831;0,472299169
130230;JUTAI;7104;6358;13462;0,527707621;0,472292379
431123;LAGOA BONITA DO SUL;1551;1388;2939;0,527730521;0,472269479
500025;ALCINOPOLIS;2897;2592;5489;0,527782838;0,472217162
150370;ITUPIRANGA;28206;25233;53439;0,527816763;0,472183237
130195;ITAMARATI;4105;3672;7777;0,527838498;0,472161502
313640;JOAQUIM FELICIO;2511;2246;4757;0,527853689;0,472146311
170770;FILADELFIA;4694;4198;8892;0,527890238;0,472109762
220323;CURRAIS;2630;2352;4982;0,527900442;0,472099558
293160;TEOLANDIA;7970;7127;15097;0,527919454;0,472080546
500490;JARAGUARI;3876;3466;7342;0,527921547;0,472078453
314535;NOVO ORIENTE DE MINAS;5703;5097;10800;0,528055556;0,471944444
311150;CAMPOS ALTOS;8270;7391;15661;0,528063342;0,471936658
431915;SAO MIGUEL DAS MISSOES;4062;3630;7692;0,528081123;0,471918877
312670;FRANCISCO SA;13974;12485;26459;0,528137874;0,471862126
313753;LAGOA GRANDE;5114;4567;9681;0,528251214;0,471748786
150030;AFUA;21083;18827;39910;0,528263593;0,471736407
150020;ACARA;29448;26296;55744;0,528272101;0,471727899
171780;PONTE ALTA DO BOM JESUS;2423;2163;4586;0,528347143;0,471652857
150410;MAGALHAES BARATA;4543;4055;8598;0,528378693;0,471621307
420250;BOM JARDIM DA SERRA;2537;2264;4801;0,528431577;0,471568423
421125;MORRO GRANDE;1524;1360;2884;0,528432732;0,471567268
110007;CORUMBIARA;3727;3325;7052;0,528502552;0,471497448
510080;APIACAS;5513;4918;10431;0,528520755;0,471479245
521160;IVOLANDIA;1213;1082;2295;0,528540305;0,471459695
150125;BANNACH;1712;1527;3239;0,528558197;0,471441803
291535;ITAGUACU DA BAHIA;7744;6906;14650;0,528600683;0,471399317
520690;DAVINOPOLIS;1107;987;2094;0,528653295;0,471346705
291345;IGRAPIUNA;6853;6110;12963;0,52865849;0,47134151
354610;SANTA CLARA D'OESTE;1116;995;2111;0,528659403;0,471340597
160040;MAZAGAO;11878;10590;22468;0,528662987;0,471337013
420417;CERRO NEGRO;1593;1420;3013;0,528708928;0,471291072
220760;PARNAGUA;5735;5111;10846;0,528766365;0,471233635
312970;IBIRACI;7471;6657;14128;0,528808041;0,471191959
170130;ARAGOMINAS;3017;2688;5705;0,528834356;0,471165644
171250;MARIANOPOLIS DO TOCANTINS;2820;2512;5332;0,528882221;0,471117779
351030;CAPELA DO ALTO;11243;10014;21257;0,528908124;0,471091876
412700;TEIXEIRA SOARES;6750;6011;12761;0,528955411;0,471044589
351515;ENGENHEIRO COELHO;11486;10226;21712;0,529016212;0,470983788
421635;SAO JOAO DO ITAPERIU;2002;1782;3784;0,529069767;0,470930233
411435;MANFRINOPOLIS;1292;1150;2442;0,529074529;0,470925471
130120;COARI;45880;40833;86713;0,529101749;0,470898251
150277;CURIONOPOLIS;9399;8365;17764;0,529103805;0,470896195
316443;SAO SEBASTIAO DA VARGEM ALEGRE;1608;1431;3039;0,529121422;0,470878578
150600;PRAINHA;15783;14044;29827;0,52915144;0,47084856
130410;TAPAUA;8930;7946;16876;0,529153828;0,470846172
210970;SAMBAIBA;3009;2677;5686;0,529194513;0,470805487
292303;NOVO HORIZONTE;6696;5957;12653;0,529202561;0,470797439
520547;CHAPADAO DO CEU;5714;5083;10797;0,52922108;0,47077892
421935;VITOR MEIRELES;2597;2310;4907;0,529243937;0,470756063
311980;CORREGO DANTA;1677;1491;3168;0,529356061;0,470643939
520580;CORUMBA DE GOIAS;5941;5282;11223;0,529359351;0,470640649
150670;SANTANA DO ARAGUAIA;40232;35763;75995;0,52940325;0,47059675
311040;CAMACHO;1503;1336;2839;0,529411765;0,470588235
355255;SUZANAPOLIS;2151;1912;4063;0,529411765;0,470588235
510060;ALTO TAQUARI;6043;5370;11413;0,529483922;0,470516078
310970;CACHOEIRA DE MINAS;6147;5462;11609;0,529502972;0,470497028
311615;CHAPADA GAUCHA;7528;6689;14217;0,529506928;0,470493072
140002;AMAJARI;7182;6379;13561;0,529606961;0,470393039
313080;INGAI;1475;1310;2785;0,52962298;0,47037702
150565;PLACAS;17121;15204;32325;0,529651972;0,470348028
171395;MURICILANDIA;1919;1704;3623;0,529671543;0,470328457
150310;GURUPA;18078;16049;34127;0,529727195;0,470272805
430595;COTIPORA;2026;1798;3824;0,529811715;0,470188285
312440;ESPIRITO SANTO DO DOURADO;2505;2223;4728;0,529822335;0,470177665
140070;UIRAMUTA;5837;5177;11014;0,529961867;0,470038133
421560;SANTA ROSA DE LIMA;1140;1011;2151;0,529986053;0,470013947
520150;APORE;2261;2005;4266;0,530004688;0,469995312
353230;NATIVIDADE DA SERRA;3511;3113;6624;0,530042271;0,469957729
352725;LOURDES;1225;1086;2311;0,530073561;0,469926439
510020;AGUA BOA;14144;12535;26679;0,530154803;0,469845197
171845;PUGMIL;1456;1290;2746;0,530225783;0,469774217
170190;ARAGUACEMA;3830;3393;7223;0,530250588;0,469749412
120034;MANOEL URBANO;5144;4557;9701;0,530254613;0,469745387
431514;PRESIDENTE LUCENA;1576;1396;2972;0,530282638;0,469717362
170382;CACHOEIRINHA;1216;1077;2293;0,530309638;0,469690362
353100;MONCOES;1206;1068;2274;0,530343008;0,469656992
354190;QUELUZ;7314;6474;13788;0,530461271;0,469538729
310720;BOCAINA DE MINAS;2699;2389;5088;0,530463836;0,469536164
140050;SAO JOAO DA BALIZA;4505;3987;8492;0,530499293;0,469500707
150650;SANTA IZABEL DO PARA;38660;34196;72856;0,530635775;0,469364225
170980;IPUEIRAS;1108;980;2088;0,530651341;0,469348659
314450;NAZARENO;4622;4088;8710;0,53065442;0,46934558
170730;DUERE;2487;2199;4686;0,530729834;0,469270166
292805;SANTA LUZIA;6533;5775;12308;0,53079298;0,46920702
150120;BAIAO;26250;23204;49454;0,530796296;0,469203704
522205;VICENTINOPOLIS;4779;4223;9002;0,530882026;0,469117974
311020;CAJURI;2103;1858;3961;0,530926534;0,469073466
312110;DELFIM MOREIRA;4252;3755;8007;0,531035344;0,468964656
314315;MONTE FORMOSO;2623;2316;4939;0,531079166;0,468920834
290740;CATOLANDIA;1922;1697;3619;0,531085935;0,468914065
316460;SAO SEBASTIAO DO OESTE;3690;3258;6948;0,531088083;0,468911917
210663;MATOES DO NORTE;9198;8118;17316;0,531185031;0,468814969
171500;NOVA ROSALANDIA;2310;2038;4348;0,531278749;0,468721251
130008;ANAMA;7595;6697;14292;0,531416177;0,468583823
150100;AVEIRO;8727;7694;16421;0,531453626;0,468546374
510310;COCALINHO;3038;2678;5716;0,531490553;0,468509447
522040;SAO SIMAO;11331;9987;21318;0,531522657;0,468477343
150250;CHAVES;12850;11325;24175;0,531540848;0,468459152
420005;ABDON BATISTA;1347;1187;2534;0,531570639;0,468429361
211027;SANTO AMARO DO MARANHAO;8623;7596;16219;0,531660398;0,468339602
521980;SAO DOMINGOS;7074;6231;13305;0,53167982;0,46832018
420208;BANDEIRANTE;1392;1226;2618;0,531703591;0,468296409
292890;SAO DESIDERIO;18488;16276;34764;0,531814521;0,468185479
500793;SONORA;10722;9436;20158;0,531898006;0,468101994
315160;PLANURA;6620;5825;12445;0,531940538;0,468059462
130014;APUI;12096;10643;22739;0,531949514;0,468050486
510610;NOSSA SENHORA DO LIVRAMENTO;6965;6128;13093;0,531963645;0,468036355
500540;MARACAJU;26037;22907;48944;0,531975319;0,468024681
140028;IRACEMA;6723;5914;12637;0,532009179;0,467990821
314625;PADRE CARVALHO;3440;3026;6466;0,53201361;0,46798639
314510;NOVA RESENDE;9012;7925;16937;0,532089508;0,467910492
510770;ROSARIO OESTE;9045;7954;16999;0,532090123;0,467909877
521680;PETROLINA DE GOIAS;5449;4791;10240;0,532128906;0,467871094
351080;CASA BRANCA;16320;14335;30655;0,532376448;0,467623552
432225;TUPANDI;2672;2347;5019;0,532376968;0,467623032
171360;MONTE DO CARMO;4356;3826;8182;0,532388169;0,467611831
130350;PAUINI;10444;9172;19616;0,532422512;0,467577488
250170;BARRA DE SAO MIGUEL;3246;2849;6095;0,532567678;0,467432322
316640;SERITINGA;989;868;1857;0,532579429;0,467420571
314055;MATA VERDE;4634;4066;8700;0,532643678;0,467356322
420090;ANGELINA;2496;2190;4686;0,532650448;0,467349552
510895;NOVA MONTE VERDE;4994;4381;9375;0,532693333;0,467306667
354165;QUADRA;2079;1823;3902;0,53280369;0,46719631
171870;RIO DOS BOIS;1534;1345;2879;0,532823897;0,467176103
410645;CORONEL DOMINGOS SOARES;4017;3521;7538;0,532899973;0,467100027
220920;SANTA FILOMENA;3334;2922;6256;0,532928389;0,467071611
510776;SANTA RITA DO TRIVELATO;1920;1682;3602;0,533037202;0,466962798
314540;OLARIA;903;791;1694;0,533057851;0,466942149
316557;SENADOR AMARAL;2860;2505;5365;0,533084809;0,466915191
510830;UNIAO DO SUL;1842;1613;3455;0,533140376;0,466859624
354025;PONTALINDA;2516;2203;4719;0,533163806;0,466836194
431446;PINHAL DA SERRA;1011;885;1896;0,533227848;0,466772152
210940;PRIMEIRA CRUZ;8290;7255;15545;0,533290447;0,466709553
500627;PARAISO DAS AGUAS;3067;2684;5751;0,533298557;0,466701443
170510;CHAPADA DA NATIVIDADE;1776;1554;3330;0,533333333;0,466666667
510629;PARANAITA;6023;5268;11291;0,533433708;0,466566292
311240;CAPETINGA;3660;3200;6860;0,533527697;0,466472303
250410;CARRAPATEIRA;1448;1266;2714;0,533529845;0,466470155
311690;COMENDADOR GOMES;1669;1459;3128;0,533567775;0,466432225
351910;IACANGA;6404;5598;12002;0,533577737;0,466422263
314940;PEDRO TEIXEIRA;963;841;1804;0,533813747;0,466186253
130210;JAPURA;937;818;1755;0,533903134;0,466096866
500310;CORGUINHO;3288;2870;6158;0,533939591;0,466060409
310660;BERTOPOLIS;2461;2148;4609;0,533955305;0,466044695
352770;LUIZIANIA;3160;2758;5918;0,533964177;0,466035823
510622;NOVA MUTUM;25760;22462;48222;0,53419601;0,46580399
311730;CONCEICAO DAS ALAGOAS;15379;13403;28782;0,53432701;0,46567299
313340;ITAPAGIPE;8289;7222;15511;0,534394946;0,465605054
521405;MUNDO NOVO;2427;2113;4540;0,534581498;0,465418502
421165;NOVO HORIZONTE;1265;1101;2366;0,53465765;0,46534235
510890;NOVA MARINGA;4842;4214;9056;0,534673145;0,465326855
316520;SAO THOME DAS LETRAS;3824;3327;7151;0,534750385;0,465249615
355690;VISTA ALEGRE DO ALTO;4900;4263;9163;0,534759358;0,465240642
150157;BOM JESUS DO TOCANTINS;9227;8027;17254;0,534774545;0,465225455
311180;CANAPOLIS;6552;5699;12251;0,534813485;0,465186515
510885;NOVA MARILANDIA;1782;1550;3332;0,534813926;0,465186074
292467;PIRAI DO NORTE;5377;4673;10050;0,535024876;0,464975124
510630;PARANATINGA;12442;10808;23250;0,535139785;0,464860215
211105;SAO JOAO DO PARAISO;5998;5209;11207;0,535201214;0,464798786
353170;MONTEIRO LOBATO;2537;2202;4739;0,535345009;0,464654991
352200;ITAJU;2108;1829;3937;0,535433071;0,464566929
431517;PROTASIO ALVES;1033;896;1929;0,535510627;0,464489373
160015;PEDRA BRANCA DO AMAPARI;9439;8186;17625;0,535546099;0,464453901
510624;NOVA UBIRATA;6692;5800;12492;0,53570285;0,46429715
420215;BELMONTE;1453;1259;2712;0,535766962;0,464233038
160070;TARTARUGALZINHO;9761;8456;18217;0,535818192;0,464181808
110145;PARECIS;3386;2933;6319;0,535844279;0,464155721
430225;BOA VISTA DO SUL;1486;1287;2773;0,535881717;0,464118283
520940;GUARANI DE GOIAS;2037;1764;3801;0,535911602;0,464088398
520320;BARRO ALTO;6240;5403;11643;0,535944344;0,464055656
130426;UARINI;7420;6419;13839;0,536165908;0,463834092
510040;ALTO GARCAS;6608;5715;12323;0,53623306;0,46376694
150304;FLORESTA DO ARAGUAIA;11128;9614;20742;0,536495998;0,463504002
317060;VARGEM BONITA;1150;993;2143;0,536630891;0,463369109
355480;TREMEMBE;25883;22345;48228;0,536679937;0,463320063
521305;MIMOSO DE GOIAS;1382;1193;2575;0,536699029;0,463300971
510835;VALE DE SAO DOMINGOS;1677;1447;3124;0,53681178;0,46318822
510185;BOM JESUS DO ARAGUAIA;3667;3163;6830;0,536896047;0,463103953
316820;TAPIRAI;1004;865;1869;0,537185661;0,462814339
314500;NOVA PONTE;8620;7426;16046;0,537205534;0,462794466
171090;ITAPIRATINS;2049;1765;3814;0,537231253;0,462768747
171570;PALMEIRANTE;3350;2884;6234;0,537375682;0,462624318
150450;MELGACO;15114;13007;28121;0,537463106;0,462536894
352150;IRAPUA;4355;3746;8101;0,537587952;0,462412048
311720;CONCEICAO DAS PEDRAS;1513;1301;2814;0,537668799;0,462331201
150034;AGUA AZUL DO NORTE;14947;12850;27797;0,537719898;0,462280102
510677;PORTO ALEGRE DO NORTE;6910;5939;12849;0,537785042;0,462214958
171790;PONTE ALTA DO TOCANTINS;4406;3786;8192;0,537841797;0,462158203
431532;QUEVEDOS;1503;1290;2793;0,538131042;0,461868958
160020;CALCOENE;6185;5308;11493;0,538153659;0,461846341
351492;ELISIARIO;2014;1728;3742;0,538214858;0,461785142
150085;ANAPU;15777;13535;29312;0,538243723;0,461756277
316660;SERRA DA SAUDADE;415;356;771;0,538261997;0,461738003
311115;CAMPO AZUL;2062;1768;3830;0,538381201;0,461618799
316810;TAPIRA;2633;2257;4890;0,538445808;0,461554192
140017;CANTA;10369;8888;19257;0,538453549;0,461546451
500800;TERENOS;12236;10485;22721;0,538532635;0,461467365
352100;IPERO;20881;17890;38771;0,538572645;0,461427355
311140;CAMPO FLORIDO;4515;3868;8383;0,538590004;0,461409996
510420;GUIRATINGA;8480;7260;15740;0,538754765;0,461245235
430003;ACEGUA;2684;2297;4981;0,538847621;0,461152379
311500;CASCALHO RICO;1675;1433;3108;0,538931789;0,461068211
130068;BOA VISTA DO RAMOS;10807;9233;20040;0,539271457;0,460728543
311210;CAPARAO;2948;2516;5464;0,539531479;0,460468521
421005;MACIEIRA;948;809;1757;0,539556061;0,460443939
292275;NOVA IBIA;3517;3001;6518;0,539582694;0,460417306
171850;RECURSOLANDIA;2369;2020;4389;0,539758487;0,460241513
521565;PALESTINA DE GOIAS;1873;1597;3470;0,539769452;0,460230548
350910;CAIUA;3248;2769;6017;0,539803889;0,460196111
411573;MATO RICO;1697;1445;3142;0,540101846;0,459898154
510794;TABAPORA;5055;4302;9357;0,540237256;0,459762744
140020;CARACARAI;12229;10406;22635;0,540269494;0,459730506
171900;SANTA TEREZA DO TOCANTINS;1582;1346;2928;0,540300546;0,459699454
353330;NOVA LUZITANIA;2279;1938;4217;0,540431586;0,459568414
430461;CANUDOS DO VALE;915;778;1693;0,540460721;0,459539279
352600;JUNQUEIROPOLIS;11339;9639;20978;0,540518639;0,459481361
350090;ALTAIR;2277;1934;4211;0,540726668;0,459273332
500348;DOIS IRMAOS DO BURITI;6244;5303;11547;0,540746514;0,459253486
313200;ITACAMBIRA;2949;2498;5447;0,541398935;0,458601065
431697;SANTA MARGARIDA DO SUL;1404;1189;2593;0,541457771;0,458542229
432235;UNIAO DA SERRA;587;497;1084;0,541512915;0,458487085
171875;RIO SONO;3520;2978;6498;0,54170514;0,45829486
140023;CAROEBE;5741;4854;10595;0,541859368;0,458140632
171240;LIZARDA;2020;1707;3727;0,541990877;0,458009123
500690;PORTO MURTINHO;9465;7995;17460;0,54209622;0,45790378
430583;COQUEIRO BAIXO;808;682;1490;0,542281879;0,457718121
150835;VITORIA DO XINGU;8368;7053;15421;0,542636664;0,457363336
510729;SAO JOSE DO POVO;2226;1876;4102;0,542662116;0,457337884
140005;ALTO ALEGRE;8280;6969;15249;0,542986425;0,457013575
130330;NOVO ARIPUANA;14365;12078;26443;0,543243959;0,456756041
510190;BRASNORTE;11176;9395;20571;0,543289096;0,456710904
170305;BANDEIRANTES DO TOCANTINS;1973;1658;3631;0,54337648;0,45662352
421567;SANTA TEREZINHA;4760;4000;8760;0,543378995;0,456621005
510777;SANTA TEREZINHA;4645;3902;8547;0,543465543;0,456534457
420165;ARVOREDO;1211;1017;2228;0,543536804;0,456463196
160025;ITAUBAL;3116;2614;5730;0,543804538;0,456195462
510385;GAUCHA DO NORTE;4305;3608;7913;0,544041451;0,455958549
150658;SANTA MARIA DAS BARREIRAS;12103;10141;22244;0,54410178;0,45589822
171630;PAU D'ARCO;2658;2227;4885;0,544114637;0,455885363
430825;FLORIANO PEIXOTO;930;779;1709;0,544177882;0,455822118
140060;SAO LUIZ;4481;3751;8232;0,544339164;0,455660836
140030;MUCAJAI;10061;8421;18482;0,544367493;0,455632507
171190;LAGOA DA CONFUSAO;7622;6367;13989;0,544856673;0,455143327
520945;GUARINOS;916;765;1681;0,544913742;0,455086258
150805;TRAIRAO;10546;8798;19344;0,545181969;0,454818031
510730;SAO JOSE DO RIO CLARO;11657;9694;21351;0,545969744;0,454030256
431237;MONTE ALEGRE DOS CAMPOS;1768;1469;3237;0,546184739;0,453815261
150445;MEDICILANDIA;17668;14679;32347;0,546202121;0,453797879
521805;PORTEIRAO;2174;1805;3979;0,546368434;0,453631566
352740;LUCELIA;12034;9988;22022;0,546453546;0,453546454
170300;BABACULANDIA;5832;4836;10668;0,546681665;0,453318335
210635;MARAJA DO SENA;4241;3516;7757;0,546731984;0,453268016
354020;PONTAL;28295;23422;51717;0,547112168;0,452887832
510452;IPIRANGA DO NORTE;4480;3702;8182;0,547543388;0,452456612
140040;NORMANDIA;6446;5326;11772;0,547570506;0,452429494
290480;CAATIBA;3413;2819;6232;0,547657253;0,452342747
171270;MATEIROS;1519;1254;2773;0,547782185;0,452217815
521945;SANTA RITA DO NOVO DESTINO;1845;1522;3367;0,547965548;0,452034452
130280;MARAA;10027;8271;18298;0,547983386;0,452016614
150780;SENADOR JOSE PORFIRIO;6198;5107;11305;0,548252985;0,451747015
353270;NIPOA;2953;2428;5381;0,548782754;0,451217246
150548;PACAJA;26976;22134;49110;0,549297495;0,450702505
130040;BARCELOS;15298;12474;27772;0,550842575;0,449157425
140047;RORAINOPOLIS;17299;14088;31387;0,551151751;0,448848249
317043;UNIAO DE MINAS;2352;1913;4265;0,551465416;0,448534584
430462;CAPAO BONITO DO SUL;898;730;1628;0,551597052;0,448402948
520430;CACU;9124;7401;16525;0,552133132;0,447866868
316905;TOCOS DO MOJI;2275;1842;4117;0,552586835;0,447413165
140015;BONFIM;7022;5679;12701;0,552869853;0,447130147
355465;TORRE DE PEDRA;1345;1087;2432;0,553042763;0,446957237
351700;GETULINA;6352;5133;11485;0,553069221;0,446930779
510631;NOVO SANTO ANTONIO;1532;1237;2769;0,553268328;0,446731672
310950;CABO VERDE;7788;6286;14074;0,553360807;0,446639193
510726;SANTO AFONSO;1752;1412;3164;0,553729456;0,446270544
520310;BALIZA;3005;2413;5418;0,554632706;0,445367294
510050;ALTO PARAGUAI;6431;5156;11587;0,555018555;0,444981445
150775;SAPUCAIA;3380;2708;6088;0,555190539;0,444809461
170720;DOIS IRMAOS DO TOCANTINS;3983;3190;7173;0,555276732;0,444723268
210405;ESTREITO;23945;19152;43097;0,555607119;0,444392881
130090;CANUTAMA;8889;7092;15981;0,556223015;0,443776985
510460;ITIQUIRA;7637;6090;13727;0,556348802;0,443651198
172015;SAO FELIX DO TOCANTINS;897;713;1610;0,557142857;0,442857143
150750;SAO JOAO DO ARAGUAIA;7862;6243;14105;0,557390996;0,442609004
510160;BARAO DE MELGACO;4552;3613;8165;0,557501531;0,442498469
430535;CHARQUEADAS;23265;18440;41705;0,557846781;0,442153219
421100;MONDAI;6715;5319;12034;0,558002327;0,441997673
352180;ITAI;15455;12177;27632;0,559315287;0,440684713
353010;MIRANDOPOLIS;16709;13135;29844;0,559878032;0,440121968
353325;NOVAIS;3398;2659;6057;0,561003797;0,438996203
520410;CACHOEIRA ALTA;7217;5626;12843;0,561940357;0,438059643
353510;PALMARES PAULISTA;7696;5995;13691;0,562121101;0,437878899
353890;PIRAJUI;14583;11356;25939;0,562203632;0,437796368
510788;SERRA NOVA DOURADA;959;746;1705;0,562463343;0,437536657
520790;FLORES DE GOIAS;9803;7612;17415;0,562905541;0,437094459
170386;CARIRI DO TOCANTINS;2545;1954;4499;0,565681263;0,434318737
316292;SAO JOAQUIM DE BICAS;18641;14055;32696;0,570130903;0,429869097
354420;RIOLANDIA;7337;5519;12856;0,570706285;0,429293715
171720;PIRAQUE;1736;1302;3038;0,571428571;0,428571429
355630;VALPARAISO;15539;11615;27154;0,572254548;0,427745452
150375;JACAREACANGA;4009;2943;6952;0,576668585;0,423331415
315070;PIRAJUBA;3747;2744;6491;0,577260823;0,422739177
355510;TUPI PAULISTA;9061;6609;15670;0,578238673;0,421761327
522220;VILA BOA;3742;2709;6451;0,580065106;0,419934894
510810;TESOURO;2198;1563;3761;0,584419037;0,415580963
351680;GASTAO VIDIGAL;2885;2026;4911;0,58745673;0,41254327
260760;ILHA DE ITAMARACA;16065;11011;27076;0,593329886;0,406670114
312125;DELTA;6539;4455;10994;0,59477897;0,40522103
421605;SAO CRISTOVAO DO SUL;3366;2280;5646;0,596174283;0,403825717
351600;FLORIDA PAULISTA;8941;5995;14936;0,598620782;0,401379218
150276;CUMARU DO NORTE;8437;5607;14044;0,600754771;0,399245229
350440;AVANHANDAVA;8481;5582;14063;0,603071891;0,396928109
352360;ITIRAPINA;11307;7303;18610;0,607576572;0,392423428
354075;POTIM;15779;9824;25603;0,616294965;0,383705035
510800;TAPURAH;8905;5475;14380;0,619262865;0,380737135
353490;PACAEMBU;8953;5373;14326;0,624947648;0,375052352
350140;ALVARO DE CARVALHO;3434;1886;5320;0,645488722;0,354511278
352160;IRAPURU;5472;2884;8356;0,654858784;0,345141216
351850;GUAREI;13316;5928;19244;0,691955934;0,308044066
355140;SERRA AZUL;10889;4403;15292;0,712071671;0,287928329
352870;MARABA PAULISTA;4362;1677;6039;0,722305017;0,277694983
421725;SAO PEDRO DE ALCANTARA;4391;1655;6046;0,726265299;0,273734701
354250;REGINOPOLIS;7299;2748;10047;0,726485518;0,273514482
351925;IARAS;7554;2232;9786;0,771919068;0,228080932
352650;LAVINIA;10594;1987;12581;0,842063429;0,157936571
354085;PRACINHA;3760;567;4327;0,86896233;0,13103767
350470;BALBINOS;5812;315;6127;0,948588216;0,051411784
